parse metadata,infra.grpc.invoker,get metadata from header,parseDataReportFlag ok,DeleteFieldValues <:REQ:>,<:staticStrategies:>,rego exec input:<:MAP:>,computeOwnObjectIDs end,build <:*:> [trace.id=<:SEQ:> <:transactionID:> <:spanID:>,<:REQ:>,AuthListByName <:<:ChineseInfo:>:>,no need or no have tags [trace.id=<:SEQ:> <:transactionID:> <:spanID:>,getDept success,getBackupEmp success,Depts only have yunzhanghu,no need or no have tags,getPermTagsAndValues <:*:>,build <:*:>,build <:*:> <:*:> [trace.id=<:SEQ:> <:transactionID:> <:spanID:>,ClientEnvHandler is <:*:>,<:GIN:>,msg,no need compute team member perm,Response=<:MAP:>,message,approve callback start,svc.ApproveCallback failed,approve status error,superiorAndDeputy empty,loaded policy count:<:NUM:>,<:list modules:>,loadRegoMySQLInterval success,strconv.ParseIn<:updateFanweiEmployee failed:>,getBackupEm<:updateFanweiEmployee failed:>,callback status error,timestamp,unknown
5274,5274,5274,5274,2029,24,277,24,147,2029,130,24,128,121,118,24,24,277,130,29,29,0,24,4,3,3,3,3,6,2,2,2,7,7,0,2023-12-20 15:00:00,3
5220,5221,5220,5220,2004,24,263,24,151,2004,112,24,133,124,118,24,24,263,112,30,30,0,24,6,6,6,6,6,12,2,2,2,9,9,0,2023-12-20 15:02:00,16
5227,5227,5227,5227,2007,22,282,22,143,2007,139,22,130,121,117,22,22,282,139,27,27,0,22,3,3,3,3,3,8,2,2,2,9,9,0,2023-12-20 15:04:00,0
5267,5265,5265,5265,2027,24,268,24,144,2027,124,24,128,120,118,24,24,268,124,27,27,0,24,3,3,3,3,3,4,2,2,2,8,8,0,2023-12-20 15:06:00,0
5254,5256,5256,5256,2031,24,255,24,146,2031,109,24,128,120,119,24,24,255,109,28,28,0,24,4,4,4,4,3,2,2,2,2,8,8,1,2023-12-20 15:08:00,0
5260,5260,5260,5260,2036,24,254,24,148,2036,106,24,126,122,119,24,24,254,106,30,30,0,24,6,6,6,6,5,6,2,2,2,4,4,1,2023-12-20 15:10:00,0
5237,5236,5236,5236,2022,24,253,24,144,2022,109,24,128,120,118,24,24,253,109,27,27,0,24,3,3,3,3,3,4,2,2,2,8,8,0,2023-12-20 15:12:00,0
5231,5230,5230,5230,2022,24,247,24,144,2022,103,24,130,123,119,24,24,247,103,27,27,0,24,3,3,3,3,3,8,2,2,2,7,7,0,2023-12-20 15:14:00,0
5283,5284,5284,5284,2027,24,287,24,148,2027,139,24,133,120,117,24,24,287,139,30,30,0,24,6,6,6,6,6,6,2,2,2,13,13,0,2023-12-20 15:16:00,0
5247,5248,5248,5248,2007,24,283,24,143,2007,140,24,129,121,118,24,24,283,140,27,27,0,24,3,3,3,3,3,6,2,2,2,8,8,0,2023-12-20 15:18:00,0
5253,5294,5252,5252,2016,24,275,24,143,2016,132,24,127,121,118,24,24,275,132,27,27,2,24,3,3,3,3,3,6,2,2,2,6,6,0,2023-12-20 15:20:00,0
5235,5236,5236,5236,2006,24,275,24,144,2006,131,24,132,121,117,24,24,275,131,27,27,2,24,3,3,3,3,3,8,2,2,2,11,11,0,2023-12-20 15:22:00,0
5257,5257,5257,5257,2016,24,415,24,279,2016,136,24,129,123,118,24,24,415,136,162,162,10,24,72,6,6,6,6,10,2,2,2,6,6,0,2023-12-20 15:24:00,198
5182,5181,5182,5182,1992,22,255,22,142,1992,113,22,132,123,117,22,22,255,113,27,27,0,22,3,3,3,3,3,12,2,2,2,9,9,0,2023-12-20 15:26:00,0
5274,5275,5274,5274,2032,24,268,24,146,2032,122,24,129,120,118,24,24,268,122,28,28,0,24,4,4,4,4,2,4,2,2,2,9,9,2,2023-12-20 15:28:00,0
5274,5274,5274,5274,2018,24,289,24,147,2018,142,24,133,121,118,24,24,289,142,30,30,0,24,6,6,6,6,6,6,2,2,2,12,12,0,2023-12-20 15:30:00,0
5231,5230,5230,5230,2014,24,262,24,143,2014,119,24,127,122,117,24,24,262,119,27,27,0,24,3,3,3,3,3,10,2,2,2,5,5,0,2023-12-20 15:32:00,0
5261,5260,5260,5260,2024,24,274,24,144,2024,130,24,123,119,118,24,24,274,130,27,27,0,24,3,3,3,3,3,2,2,2,2,4,4,0,2023-12-20 15:34:00,0
5232,5233,5234,5234,2007,24,266,24,143,2007,123,24,133,124,118,24,24,266,123,27,27,0,24,3,3,3,3,3,12,2,2,2,9,9,0,2023-12-20 15:36:00,0
5268,5268,5268,5268,2028,24,268,24,148,2028,120,24,131,122,118,24,24,268,120,30,30,4,24,6,6,6,6,6,8,2,2,2,9,9,0,2023-12-20 15:38:00,0
5281,5280,5280,5280,2023,24,279,24,144,2023,135,24,138,128,118,24,24,279,135,27,27,0,24,3,3,3,3,3,20,2,2,2,10,10,0,2023-12-20 15:40:00,0
5203,5204,5204,5204,2003,24,316,24,203,2003,113,24,128,121,117,24,24,316,113,87,87,0,24,33,3,3,3,3,8,2,2,2,7,7,0,2023-12-20 15:42:00,90
5230,5228,5228,5228,2018,24,262,24,155,2018,107,24,132,123,118,24,24,262,107,38,38,0,24,10,6,6,6,6,10,2,2,2,9,9,0,2023-12-20 15:44:00,12
5264,5266,5266,5266,2027,24,394,24,269,2027,125,24,130,121,119,24,24,394,125,152,152,0,24,65,3,3,3,2,4,2,2,2,9,9,1,2023-12-20 15:46:00,188
5224,5223,5223,5223,1999,24,291,23,144,1999,147,23,131,122,116,23,23,291,147,28,28,0,23,4,4,4,4,3,12,2,2,2,9,9,1,2023-12-20 15:48:00,0
5278,5299,5279,5279,2032,22,276,23,145,2032,131,23,128,122,119,23,23,276,131,27,27,5,23,3,3,3,3,3,6,2,2,2,6,6,0,2023-12-20 15:50:00,0
5272,5272,5272,5272,2030,24,275,24,147,2030,128,24,130,122,118,24,24,275,128,30,30,5,24,6,6,6,6,6,8,2,2,2,8,8,0,2023-12-20 15:52:00,0
5264,5283,5263,5263,2029,24,263,24,144,2029,119,24,130,125,119,24,24,263,119,27,27,0,24,3,3,3,3,3,12,2,2,2,5,5,0,2023-12-20 15:54:00,0
5256,5256,5256,5256,2011,24,284,24,144,2011,140,24,132,119,117,24,24,284,140,27,27,0,24,3,3,3,3,3,4,2,2,2,13,13,0,2023-12-20 15:56:00,0
5250,5251,5251,5251,2015,24,277,24,144,2015,133,24,126,119,118,24,24,277,133,27,27,0,24,3,3,3,3,3,2,2,2,2,7,7,0,2023-12-20 15:58:00,2
5267,5267,5267,5267,2024,24,270,24,147,2024,123,24,132,122,118,24,24,270,123,30,30,0,24,6,6,6,6,6,8,2,2,2,10,10,0,2023-12-20 16:00:00,0
5231,5230,5230,5230,2006,24,271,24,144,2006,127,24,128,121,119,24,24,271,127,27,27,0,24,3,3,3,3,3,4,2,2,2,7,7,0,2023-12-20 16:02:00,0
5274,5275,5275,5275,2027,24,374,24,145,2027,229,24,132,120,119,24,24,374,229,28,28,0,24,4,4,4,4,3,2,2,2,2,12,12,1,2023-12-20 16:04:00,0
5237,5237,5237,5237,2019,24,257,24,147,2019,110,24,129,120,118,24,24,257,110,30,30,10,24,6,6,6,6,5,4,2,2,2,9,9,1,2023-12-20 16:06:00,0
5271,5271,5271,5271,2027,24,276,24,144,2027,132,24,126,120,118,24,24,276,132,27,27,0,24,3,3,3,3,3,4,2,2,2,6,6,0,2023-12-20 16:08:00,0
5221,5220,5220,5220,2020,24,246,24,145,2020,101,24,130,122,118,24,24,246,101,27,27,0,24,3,3,3,3,3,8,2,2,2,8,8,0,2023-12-20 16:10:00,0
5255,5256,5256,5256,2022,30,275,25,143,2023,132,25,123,120,117,25,24,275,132,27,27,0,24,3,3,3,3,3,6,2,2,2,3,3,0,2023-12-20 16:12:00,2
5256,5255,5255,5255,2032,22,255,22,148,2032,107,22,127,121,119,22,22,255,107,30,30,0,22,6,6,6,6,6,4,2,2,2,6,6,0,2023-12-20 16:14:00,0
5261,5261,5261,5261,2027,24,270,24,144,2027,126,24,128,121,120,24,24,270,126,27,27,0,24,3,3,3,3,3,2,2,2,2,7,7,0,2023-12-20 16:16:00,0
5245,5246,5246,5246,2011,24,273,24,144,2011,129,24,132,122,118,24,24,273,129,27,27,0,24,3,3,3,3,3,8,2,2,2,10,10,0,2023-12-20 16:18:00,0
5261,5259,5260,5260,2022,24,273,24,147,2022,126,24,127,121,118,24,24,273,126,30,30,0,24,6,6,6,6,6,6,2,2,2,6,6,0,2023-12-20 16:20:00,0
5235,5235,5234,5234,2020,24,259,24,144,2020,115,24,124,119,118,24,24,259,115,27,27,0,24,3,3,3,3,3,2,2,2,2,5,5,0,2023-12-20 16:22:00,0
5245,5246,5246,5246,2028,24,254,24,144,2028,110,24,125,122,118,24,24,254,110,27,27,0,24,3,3,3,3,2,8,2,2,2,3,3,1,2023-12-20 16:24:00,0
5255,5254,5255,5255,2018,24,278,24,145,2018,133,24,130,120,118,24,24,278,133,28,28,0,24,4,4,4,4,3,4,2,2,2,10,10,1,2023-12-20 16:26:00,0
5252,5254,5253,5253,2024,24,264,24,147,2024,117,24,131,124,118,24,24,264,117,30,30,0,24,6,6,6,6,6,12,2,2,2,7,7,0,2023-12-20 16:28:00,0
5263,5260,5260,5260,2034,24,252,24,145,2034,107,24,128,121,118,24,24,252,107,27,27,0,24,3,3,3,3,3,6,2,2,2,7,7,0,2023-12-20 16:30:00,0
5228,5230,5230,5230,2016,24,265,24,143,2016,122,24,130,121,118,24,24,265,122,27,27,18,24,3,3,3,3,3,6,2,2,2,9,9,0,2023-12-20 16:32:00,0
5183,5183,5183,5183,2033,24,194,24,145,2033,49,24,120,119,118,24,24,194,49,27,27,0,24,3,3,3,3,3,2,2,2,2,1,1,0,2023-12-20 16:34:00,0
5150,5150,5150,5150,2019,24,184,24,146,2019,38,24,120,119,118,24,24,184,38,30,30,0,24,6,6,6,6,6,2,2,2,2,1,1,0,2023-12-20 16:36:00,0
5191,5192,5192,5192,2028,24,202,24,145,2028,57,24,125,120,118,24,24,202,57,27,27,0,24,3,3,3,3,3,4,2,2,2,5,5,0,2023-12-20 16:38:00,0
5170,5168,5168,5168,2029,22,186,22,144,2029,42,22,122,120,118,22,22,186,42,27,27,0,22,3,3,3,3,3,4,2,2,2,2,2,0,2023-12-20 16:40:00,0
5140,5142,5141,5141,2016,24,184,24,147,2016,37,24,120,120,118,24,24,184,37,30,30,0,24,6,6,6,6,5,4,2,2,2,0,0,1,2023-12-20 16:42:00,0
5180,5181,5181,5181,2034,24,189,24,146,2034,43,24,121,119,118,24,24,189,43,28,28,4,24,4,4,4,4,3,2,2,2,2,2,2,1,2023-12-20 16:44:00,0
5145,5145,5145,5145,2024,24,170,24,144,2024,26,24,120,120,118,24,24,170,26,27,27,0,24,3,3,3,3,3,4,2,2,2,0,0,0,2023-12-20 16:46:00,0
5165,5165,5165,5165,2029,24,185,24,144,2029,41,24,118,118,118,24,24,185,41,27,27,0,24,3,3,3,3,3,0,2,2,2,0,0,0,2023-12-20 16:48:00,0
5157,5180,5157,5157,2021,24,239,24,148,2021,91,24,124,121,118,24,24,239,40,31,31,0,24,7,7,6,6,6,6,2,2,2,3,3,0,2023-12-20 16:50:00,52
5173,5173,5173,5173,2027,24,194,24,144,2027,50,24,121,118,118,24,24,194,50,27,27,0,24,3,3,3,3,3,0,2,2,2,3,3,0,2023-12-20 16:52:00,0
5130,5131,5130,5130,2011,24,186,24,143,2011,43,24,119,117,117,24,24,186,43,27,27,0,24,3,3,3,3,3,0,2,2,2,2,2,0,2023-12-20 16:54:00,0
5159,5158,5158,5158,2026,24,177,24,144,2026,33,24,125,120,118,24,24,177,33,27,27,0,24,3,3,3,3,3,4,2,2,2,5,5,0,2023-12-20 16:56:00,0
5159,5160,5160,5160,2018,24,196,24,147,2018,49,24,121,118,118,24,24,196,49,30,30,0,24,6,6,6,6,6,0,2,2,2,3,3,0,2023-12-20 16:58:00,0
5177,5177,5177,5177,2031,24,185,24,144,2031,41,24,123,120,119,24,24,185,41,27,27,0,24,3,3,3,3,3,2,2,2,2,3,3,0,2023-12-20 17:00:00,0
5160,5158,5158,5158,2019,24,294,24,146,2019,148,24,122,120,119,24,24,294,148,28,28,0,24,4,4,4,4,2,2,2,2,2,2,2,2,2023-12-20 17:02:00,0
5153,5154,5154,5154,2017,22,192,22,147,2017,45,22,122,119,118,22,22,192,45,30,30,0,22,6,6,6,6,6,2,2,2,2,3,3,0,2023-12-20 17:04:00,0
5153,5153,5153,5153,2019,24,188,24,143,2019,45,24,120,119,118,24,24,188,45,27,27,0,24,3,3,3,3,3,2,2,2,2,1,1,0,2023-12-20 17:06:00,0
5183,5184,5184,5184,2030,24,195,24,145,2030,50,24,122,120,118,24,24,195,50,27,27,0,24,3,3,3,3,3,4,2,2,2,2,2,0,2023-12-20 17:08:00,0
5174,5174,5174,5174,2031,24,187,24,144,2031,43,24,121,120,118,24,24,187,43,27,27,0,24,3,3,3,3,3,4,2,2,2,1,1,0,2023-12-20 17:10:00,0
5188,5189,5188,5188,2025,24,216,24,147,2025,69,24,123,120,119,24,24,216,69,30,30,4,24,6,6,6,6,6,2,2,2,2,3,3,0,2023-12-20 17:12:00,0
5205,5204,5204,5204,2028,24,390,24,317,2028,73,24,132,124,119,24,24,390,73,199,199,0,24,89,3,3,3,3,10,2,2,2,8,8,0,2023-12-20 17:14:00,258
5205,5206,5206,5206,2007,24,282,24,158,2007,124,24,131,126,117,24,24,282,124,42,42,0,24,11,3,3,3,3,18,2,2,2,5,5,0,2023-12-20 17:16:00,24
5250,5250,5250,5250,2033,24,263,24,147,2033,116,24,130,120,118,24,24,263,116,30,30,0,24,6,6,6,6,6,4,2,2,2,10,10,0,2023-12-20 17:18:00,0
5220,5220,5220,5220,2021,30,245,25,144,2022,101,25,132,123,119,25,24,245,101,27,27,0,24,3,3,3,3,2,8,2,2,2,9,9,1,2023-12-20 17:20:00,2
5247,5247,5247,5247,2017,30,286,25,147,2018,139,25,125,120,118,25,24,286,139,30,30,2,24,5,4,4,4,3,4,2,2,2,5,5,1,2023-12-20 17:22:00,5
5161,5161,5161,5161,2023,24,195,24,144,2023,51,24,121,118,118,24,24,195,51,27,27,3,24,3,3,3,3,3,0,2,2,2,3,3,0,2023-12-20 17:24:00,0
5181,5181,5181,5181,2023,24,212,24,147,2023,65,24,125,118,117,24,24,212,65,30,30,0,24,6,6,6,6,6,2,2,2,2,7,7,0,2023-12-20 17:26:00,0
5175,5174,5174,5174,2020,24,207,24,144,2020,63,24,124,118,118,24,24,207,63,27,27,0,24,3,3,3,3,3,0,2,2,2,6,6,0,2023-12-20 17:28:00,0
5178,5202,5179,5179,2026,22,200,22,144,2026,56,22,125,121,118,22,22,200,56,27,27,0,22,3,3,3,3,3,6,2,2,2,4,4,0,2023-12-20 17:30:00,0
5192,5191,5191,5191,2032,24,199,24,145,2032,54,24,125,119,119,24,24,199,54,27,27,0,24,3,3,3,3,3,0,2,2,2,6,6,0,2023-12-20 17:32:00,0
5196,5218,5197,5197,2029,24,211,24,147,2029,64,24,127,121,118,24,24,211,64,30,30,0,24,6,6,6,6,6,6,2,2,2,6,6,0,2023-12-20 17:34:00,0
5136,5136,5136,5136,2010,24,190,24,146,2010,44,24,121,118,118,24,24,190,44,29,29,0,24,4,3,3,3,3,0,2,2,2,3,3,0,2023-12-20 17:36:00,3
5162,5165,5161,5161,2024,24,188,24,145,2024,43,24,121,120,118,24,24,188,43,28,28,0,24,4,4,4,4,3,4,2,2,2,1,1,1,2023-12-20 17:38:00,0
5120,5120,5120,5120,2009,24,195,24,146,2009,49,24,121,118,117,24,24,195,49,30,30,0,24,6,6,6,6,5,2,2,2,2,3,3,1,2023-12-20 17:40:00,0
5200,5203,5200,5200,2012,24,250,24,144,2012,106,24,127,122,119,24,24,250,106,27,27,4,24,3,3,3,3,3,6,2,2,2,5,5,0,2023-12-20 17:42:00,0
5268,5269,5269,5269,2017,24,303,24,144,2017,159,24,131,123,119,24,24,303,159,27,27,0,24,3,3,3,3,3,8,2,2,2,8,8,0,2023-12-20 17:44:00,0
5244,5245,5244,5244,2018,24,284,24,144,2018,140,24,127,124,119,24,24,284,140,27,27,0,24,3,3,3,3,3,10,2,2,2,3,3,0,2023-12-20 17:46:00,2
5230,5230,5230,5230,2019,24,272,24,149,2019,123,24,127,119,119,24,24,272,123,32,32,6,24,7,6,6,6,6,0,2,2,2,8,8,0,2023-12-20 17:48:00,3
5245,5244,5244,5244,2026,24,268,24,146,2026,122,24,130,121,118,24,24,268,122,29,29,1,24,4,3,3,3,3,6,2,2,2,9,9,0,2023-12-20 17:50:00,3
5202,5226,5202,5202,2029,24,226,24,145,2029,81,24,125,122,118,24,24,226,81,27,27,2,24,3,3,3,3,3,8,2,2,2,3,3,0,2023-12-20 17:52:00,0
5176,5178,5177,5177,2024,22,209,22,146,2024,63,22,122,119,118,22,22,209,63,29,29,0,22,4,3,3,3,3,2,2,2,2,3,3,0,2023-12-20 17:54:00,3
5173,5173,5173,5173,2027,24,204,24,147,2027,57,24,122,120,118,24,24,204,57,30,30,0,24,6,6,6,6,6,4,2,2,2,2,2,0,2023-12-20 17:56:00,0
5164,5163,5163,5163,2020,24,202,24,144,2020,58,24,121,120,117,24,24,202,58,27,27,0,24,3,3,3,3,2,6,2,2,2,1,1,1,2023-12-20 17:58:00,0
5165,5166,5166,5166,2021,24,196,24,145,2021,51,24,124,119,119,24,24,196,51,28,28,0,24,4,4,4,4,3,0,2,2,2,5,5,1,2023-12-20 18:00:00,0
5113,5116,5112,5112,1991,24,213,24,146,1991,67,24,120,117,117,24,24,213,67,30,30,5,24,6,6,6,6,6,0,2,2,2,3,3,0,2023-12-20 18:02:00,0
5175,5176,5176,5176,2035,24,192,24,145,2035,47,24,123,120,120,24,24,192,47,27,27,4,24,3,3,3,3,3,0,2,2,2,3,3,0,2023-12-20 18:04:00,0
5150,5149,5149,5149,2014,24,207,24,144,2014,63,24,118,118,117,24,24,207,63,28,28,0,24,4,4,4,4,3,2,2,2,2,0,0,1,2023-12-20 18:06:00,0
5210,5211,5211,5211,2043,24,205,24,146,2043,59,24,122,120,119,24,24,205,59,27,27,4,24,3,3,3,3,3,2,2,2,2,2,2,0,2023-12-20 18:08:00,0
5181,5180,5180,5180,2035,24,196,24,148,2035,48,24,121,120,118,24,24,196,48,31,31,0,24,7,7,7,7,6,4,2,2,2,1,1,1,2023-12-20 18:10:00,0
5163,5164,5164,5164,2016,24,205,24,144,2016,61,24,122,119,118,24,24,205,61,27,27,0,24,3,3,3,3,3,2,2,2,2,3,3,0,2023-12-20 18:12:00,0
5142,5144,5142,5142,2014,24,190,24,145,2014,45,24,126,120,119,24,24,190,45,28,28,0,24,4,4,4,4,4,2,2,2,2,6,6,0,2023-12-20 18:14:00,0
5145,5145,5145,5145,2020,24,187,24,145,2020,42,24,120,119,118,24,24,187,42,28,28,0,24,4,4,4,4,4,2,2,2,2,1,1,0,2023-12-20 18:16:00,0
5179,5201,5178,5178,2026,23,207,23,147,2026,60,23,123,118,118,23,23,207,60,30,30,0,23,6,6,6,6,6,0,2,2,2,5,5,0,2023-12-20 18:18:00,0
5162,5163,5163,5163,2015,23,209,23,144,2015,65,23,122,119,118,23,23,209,65,27,27,2,23,3,3,3,3,3,2,2,2,2,3,3,0,2023-12-20 18:20:00,0
5161,5161,5161,5161,2015,24,205,24,145,2015,60,24,125,120,118,24,24,205,60,28,28,3,24,4,4,4,4,3,4,2,2,2,5,5,1,2023-12-20 18:22:00,0
5193,5195,5193,5193,2034,24,205,24,148,2034,57,24,124,119,118,24,24,205,57,30,30,1,24,6,6,6,6,6,2,2,2,2,5,5,0,2023-12-20 18:24:00,0
5121,5122,5121,5121,2010,24,189,24,143,2010,46,24,121,120,117,24,24,189,46,27,27,0,24,3,3,3,3,3,6,2,2,2,1,1,0,2023-12-20 18:26:00,0
5177,5177,5177,5177,2027,24,205,24,145,2027,60,24,122,120,118,24,24,205,60,28,28,0,24,4,4,4,4,3,4,2,2,2,2,2,1,2023-12-20 18:28:00,0
5210,5212,5210,5210,2041,24,213,24,145,2041,68,24,124,120,119,24,24,213,68,27,27,7,24,3,3,3,3,3,2,2,2,2,4,4,0,2023-12-20 18:30:00,0
5156,5156,5156,5156,2018,24,209,24,148,2018,61,24,120,119,118,24,24,209,61,31,31,0,24,7,7,7,7,7,2,2,2,2,1,1,0,2023-12-20 18:32:00,0
5203,5202,5202,5202,2027,24,228,24,144,2027,84,24,121,119,118,24,24,228,84,27,27,0,24,3,3,3,3,3,2,2,2,2,2,2,0,2023-12-20 18:34:00,0
5196,5197,5197,5197,2029,24,217,24,145,2029,72,24,125,120,118,24,24,217,72,28,28,0,24,4,4,4,4,4,4,2,2,2,5,5,0,2023-12-20 18:36:00,0
5200,5200,5200,5200,2030,24,213,24,148,2030,65,24,125,120,118,24,24,213,65,30,30,0,24,6,6,6,6,6,4,2,2,2,5,5,0,2023-12-20 18:38:00,0
5182,5181,5181,5181,2023,24,215,24,145,2023,70,24,122,119,118,24,24,215,70,28,28,0,24,4,4,4,4,3,2,2,2,2,3,3,1,2023-12-20 18:40:00,0
5138,5138,5138,5138,2008,24,206,24,143,2008,63,24,119,118,118,24,24,206,63,27,27,0,24,3,3,3,3,3,0,2,2,2,1,1,0,2023-12-20 18:42:00,0
5167,5168,5168,5168,2019,22,207,22,145,2019,62,22,127,121,118,22,22,207,62,28,28,0,22,4,4,4,4,3,6,2,2,2,6,6,1,2023-12-20 18:44:00,0
5186,5185,5185,5185,2022,24,224,24,147,2022,77,24,126,120,117,24,24,224,77,30,30,0,24,6,6,6,6,6,6,2,2,2,6,6,0,2023-12-20 18:46:00,0
5139,5140,5140,5140,2003,24,217,24,144,2003,73,24,121,117,117,24,24,217,73,28,28,0,24,4,4,4,4,4,0,2,2,2,4,4,0,2023-12-20 18:48:00,0
5195,5195,5195,5195,2036,24,255,24,145,2036,110,24,124,121,119,24,24,255,59,28,28,0,24,4,4,3,3,3,4,2,2,2,3,3,0,2023-12-20 18:50:00,52
5182,5182,5182,5182,2029,24,208,24,149,2029,59,24,120,119,118,24,24,208,59,31,31,0,24,7,7,7,7,7,2,2,2,2,1,1,0,2023-12-20 18:52:00,0
5172,5171,5171,5171,2017,24,210,24,143,2017,67,24,126,119,117,24,24,210,67,27,27,0,24,3,3,3,3,3,4,2,2,2,7,7,0,2023-12-20 18:54:00,0
5204,5205,5205,5205,2023,24,226,24,144,2023,82,24,129,123,119,24,24,226,82,27,27,0,24,3,3,3,3,3,8,2,2,2,6,6,0,2023-12-20 18:56:00,0
5166,5166,5166,5166,2017,24,206,24,145,2017,61,24,125,121,118,24,24,206,61,28,28,0,24,4,4,4,4,3,6,2,2,2,4,4,1,2023-12-20 18:58:00,0
5192,5192,5192,5192,2027,24,219,24,147,2027,72,24,125,120,118,24,24,219,72,30,30,0,24,6,6,6,6,6,4,2,2,2,5,5,0,2023-12-20 19:00:00,0
5133,5132,5132,5132,2003,24,309,24,145,2003,164,24,122,119,118,24,24,309,164,28,28,0,24,4,4,4,4,3,2,2,2,2,3,3,1,2023-12-20 19:02:00,0
5143,5144,5144,5144,2016,24,196,24,143,2016,53,24,121,118,118,24,24,196,53,27,27,0,24,3,3,3,3,3,0,2,2,2,3,3,0,2023-12-20 19:04:00,0
5144,5166,5143,5143,2017,24,194,24,145,2017,49,24,119,118,117,24,24,194,49,28,28,0,24,4,4,4,4,4,2,2,2,2,1,1,0,2023-12-20 19:06:00,0
5184,5184,5184,5184,2026,22,219,22,147,2026,72,22,123,119,118,22,22,219,72,30,30,0,22,6,6,6,6,6,2,2,2,2,4,4,0,2023-12-20 19:08:00,0
5114,5138,5115,5115,1997,24,209,24,144,1997,65,24,120,118,117,24,24,209,65,28,28,0,24,4,4,4,4,4,2,2,2,2,2,2,0,2023-12-20 19:10:00,0
5167,5167,5167,5167,2023,24,200,24,144,2023,56,24,120,120,118,24,24,200,56,27,27,0,24,3,3,3,3,3,4,2,2,2,0,0,0,2023-12-20 19:12:00,0
5198,5198,5198,5198,2042,24,202,24,149,2042,53,24,121,120,119,24,24,202,53,31,31,0,24,7,7,7,7,6,2,2,2,2,1,1,1,2023-12-20 19:14:00,0
5165,5164,5164,5164,2023,24,194,24,144,2023,50,24,123,120,119,24,24,194,50,27,27,0,24,3,3,3,3,3,2,2,2,2,3,3,0,2023-12-20 19:16:00,0
5164,5164,5164,5164,2028,24,186,24,144,2028,42,24,125,122,119,24,24,186,42,27,27,0,24,3,3,3,3,3,6,2,2,2,3,3,0,2023-12-20 19:18:00,0
5204,5205,5205,5205,2036,24,216,24,146,2036,70,24,121,120,118,24,24,216,70,28,28,0,24,4,4,4,4,3,4,2,2,2,1,1,1,2023-12-20 19:20:00,0
5181,5181,5181,5181,2017,24,223,24,148,2017,75,24,126,121,119,24,24,223,75,31,31,0,24,7,7,7,7,7,4,2,2,2,5,5,0,2023-12-20 19:22:00,0
5144,5144,5144,5144,2008,24,201,24,144,2008,57,24,124,121,117,24,24,201,57,27,27,0,24,3,3,3,3,3,8,2,2,2,3,3,0,2023-12-20 19:24:00,0
5213,5213,5213,5213,2040,24,213,24,145,2040,68,24,124,120,119,24,24,213,68,27,27,0,24,3,3,3,3,3,2,2,2,2,4,4,0,2023-12-20 19:26:00,0
5197,5197,5197,5197,2030,24,221,24,148,2030,73,24,124,120,118,24,24,221,73,31,31,0,24,7,7,7,7,7,4,2,2,2,4,4,0,2023-12-20 19:28:00,0
5200,5199,5199,5199,2033,24,216,24,145,2033,71,24,120,119,118,24,24,216,71,27,27,0,24,3,3,3,3,3,2,2,2,2,1,1,0,2023-12-20 19:30:00,0
5162,5163,5163,5163,2019,22,207,22,144,2019,63,22,126,120,118,22,22,207,63,27,27,0,22,4,4,4,4,3,4,2,2,2,6,6,1,2023-12-20 19:32:00,0
5196,5195,5195,5195,2033,24,207,24,144,2033,63,24,124,121,118,24,24,207,63,27,27,0,24,3,3,3,3,3,6,2,2,2,3,3,0,2023-12-20 19:34:00,0
5170,5171,5171,5171,2018,24,213,24,148,2018,65,24,120,119,118,24,24,213,65,31,31,0,24,7,7,7,7,6,2,2,2,2,1,1,1,2023-12-20 19:36:00,0
5194,5194,5194,5194,2020,24,226,24,143,2020,83,24,130,121,118,24,24,226,83,27,27,0,24,3,3,3,3,3,6,2,2,2,9,9,0,2023-12-20 19:38:00,0
5159,5158,5158,5158,2014,24,200,24,145,2014,55,24,126,119,118,24,24,200,55,28,28,0,24,4,4,4,4,4,2,2,2,2,7,7,0,2023-12-20 19:40:00,0
5176,5174,5174,5174,2021,24,206,24,144,2021,62,24,126,120,118,24,24,206,62,27,27,0,24,3,3,3,3,3,4,2,2,2,6,6,0,2023-12-20 19:42:00,0
5158,5160,5160,5160,2012,24,212,24,149,2012,63,24,125,122,118,24,24,212,63,32,32,0,24,7,7,7,7,7,8,2,2,2,3,3,0,2023-12-20 19:44:00,0
5164,5162,5162,5162,2016,24,206,24,143,2016,63,24,122,118,118,24,24,206,63,27,27,0,24,3,3,3,3,3,0,2,2,2,4,4,0,2023-12-20 19:46:00,0
5191,5194,5194,5194,2019,24,240,24,145,2019,95,24,118,118,117,24,24,240,95,28,28,0,24,4,4,4,4,3,2,2,2,2,0,0,1,2023-12-20 19:48:00,0
5209,5209,5209,5209,2034,24,273,24,149,2034,124,24,126,120,119,24,24,273,73,31,31,0,24,7,7,6,6,6,2,2,2,2,6,6,0,2023-12-20 19:50:00,52
5166,5166,5166,5166,2018,24,209,24,144,2018,65,24,119,119,118,24,24,209,65,27,27,0,24,3,3,3,3,3,2,2,2,2,0,0,0,2023-12-20 19:52:00,0
5136,5136,5136,5136,2009,22,206,22,143,2009,63,22,123,121,118,22,22,206,63,27,27,0,22,4,4,4,4,3,6,2,2,2,2,2,1,2023-12-20 19:54:00,0
5185,5185,5185,5185,2030,24,201,24,145,2030,56,24,121,118,118,24,24,201,56,27,27,0,24,3,3,3,3,3,0,2,2,2,3,3,0,2023-12-20 19:56:00,0
5186,5205,5186,5186,2024,24,224,24,148,2024,76,24,120,119,118,24,24,224,76,31,31,0,24,7,7,7,7,7,2,2,2,2,1,1,0,2023-12-20 19:58:00,0
5162,5161,5161,5161,2024,24,193,24,144,2024,49,24,122,122,118,24,24,193,49,27,27,9,24,3,3,3,3,3,8,2,2,2,0,0,0,2023-12-20 20:00:00,0
5166,5165,5165,5165,2012,24,318,24,145,2012,173,24,121,119,118,24,24,318,173,28,28,2,24,4,4,4,4,4,2,2,2,2,2,2,0,2023-12-20 20:02:00,0
5182,5183,5183,5183,2022,24,215,24,145,2022,70,24,125,121,119,24,24,215,70,28,28,0,24,4,4,4,4,3,4,2,2,2,4,4,1,2023-12-20 20:04:00,0
5184,5182,5182,5182,2023,24,217,24,148,2023,69,24,124,121,118,24,24,217,69,31,31,0,24,7,7,7,7,7,6,2,2,2,3,3,0,2023-12-20 20:06:00,0
5171,5174,5174,5174,2015,24,218,24,143,2015,75,24,121,119,118,24,24,218,75,27,27,0,24,3,3,3,3,3,2,2,2,2,2,2,0,2023-12-20 20:08:00,0
5192,5192,5192,5192,2032,24,212,24,146,2032,66,24,119,118,118,24,24,212,66,28,28,0,24,4,4,4,4,3,0,2,2,2,1,1,1,2023-12-20 20:10:00,0
5139,5139,5139,5139,2007,24,200,24,148,2007,52,24,124,121,118,24,24,200,52,32,32,0,24,8,8,8,8,8,6,2,2,2,3,3,0,2023-12-20 20:12:00,0
5188,5188,5188,5188,2031,24,208,24,145,2031,63,24,122,119,118,24,24,208,63,27,27,0,24,3,3,3,3,3,2,2,2,2,3,3,0,2023-12-20 20:14:00,0
5167,5166,5166,5166,2020,24,200,24,145,2020,55,24,126,123,118,24,24,200,55,28,28,0,24,4,4,4,4,4,10,2,2,2,3,3,0,2023-12-20 20:16:00,0
5108,5108,5108,5108,2010,22,178,22,144,2010,34,22,119,117,117,22,22,178,34,28,28,0,22,4,4,4,4,4,0,2,2,2,2,2,0,2023-12-20 20:18:00,0
5217,5218,5218,5218,2037,24,227,24,149,2037,78,24,122,119,119,24,24,227,78,31,31,0,24,7,7,7,7,6,0,2,2,2,3,3,1,2023-12-20 20:20:00,0
5168,5168,5168,5168,2012,24,216,24,145,2012,71,24,128,120,118,24,24,216,71,28,28,0,24,4,4,4,4,4,4,2,2,2,8,8,0,2023-12-20 20:22:00,0
5202,5202,5202,5202,2026,24,228,24,145,2026,83,24,122,120,118,24,24,228,83,28,28,0,24,4,4,4,4,3,4,2,2,2,2,2,1,2023-12-20 20:24:00,0
5155,5155,5155,5155,2018,24,200,24,148,2018,52,24,123,120,118,24,24,200,52,31,31,0,24,7,7,7,7,7,4,2,2,2,3,3,0,2023-12-20 20:26:00,0
5161,5160,5160,5160,2013,24,202,24,144,2013,58,24,126,121,118,24,24,202,58,28,28,0,24,4,4,4,4,4,6,2,2,2,5,5,0,2023-12-20 20:28:00,0
5169,5169,5169,5169,2021,24,197,24,144,2021,53,24,124,119,117,24,24,197,53,27,27,0,24,3,3,3,3,3,4,2,2,2,5,5,0,2023-12-20 20:30:00,0
5204,5205,5205,5205,2032,24,223,24,146,2032,77,24,124,121,119,24,24,223,77,28,28,0,24,4,4,4,4,4,4,2,2,2,3,3,0,2023-12-20 20:32:00,0
5169,5168,5168,5168,2018,24,209,24,148,2018,61,24,125,121,118,24,24,209,61,31,31,0,24,7,7,7,7,7,6,2,2,2,4,4,0,2023-12-20 20:34:00,0
5161,5162,5162,5162,2019,24,201,24,145,2019,56,24,119,118,118,24,24,201,56,28,28,0,24,4,4,4,4,3,0,2,2,2,1,1,1,2023-12-20 20:36:00,0
5196,5196,5196,5196,2027,24,226,24,145,2027,81,24,122,120,119,24,24,226,81,28,28,0,24,4,4,4,4,4,2,2,2,2,2,2,0,2023-12-20 20:38:00,0
5151,5151,5151,5151,2012,24,213,24,144,2012,69,24,122,118,117,24,24,213,69,28,28,0,24,4,4,4,4,3,2,2,2,2,4,4,1,2023-12-20 20:40:00,0
5133,5154,5133,5133,2014,22,191,22,148,2014,43,22,122,121,119,22,22,191,43,31,31,0,22,7,7,7,7,7,4,2,2,2,1,1,0,2023-12-20 20:42:00,0
5169,5169,5169,5169,2010,24,225,24,145,2010,80,24,124,119,117,24,24,225,80,28,28,0,24,4,4,4,4,4,4,2,2,2,5,5,0,2023-12-20 20:44:00,0
5157,5157,5157,5157,2012,24,205,24,143,2012,62,24,125,121,118,24,24,205,62,27,27,0,24,3,3,3,3,3,6,2,2,2,4,4,0,2023-12-20 20:46:00,1
5183,5183,5183,5183,2024,24,216,24,149,2024,67,24,125,121,118,24,24,216,67,32,32,0,24,8,8,8,8,8,6,2,2,2,4,4,0,2023-12-20 20:48:00,0
5161,5161,5161,5161,2020,24,247,24,145,2020,102,24,124,120,118,24,24,247,51,28,28,10,24,4,4,3,3,3,4,2,2,2,4,4,0,2023-12-20 20:50:00,52
5172,5171,5171,5171,2024,24,200,24,145,2024,55,24,130,122,118,24,24,200,55,28,28,0,24,4,4,4,4,3,8,2,2,2,8,8,1,2023-12-20 20:52:00,0
5176,5178,5176,5176,2013,24,230,24,144,2013,86,24,122,120,117,24,24,230,86,28,28,0,24,4,4,4,4,4,6,2,2,2,2,2,0,2023-12-20 20:54:00,0
5202,5203,5203,5203,2030,24,221,24,149,2030,72,24,122,121,119,24,24,221,72,31,31,0,24,7,7,7,7,6,4,2,2,2,1,1,1,2023-12-20 20:56:00,0
5198,5197,5197,5197,2026,24,228,24,145,2026,83,24,122,119,119,24,24,228,83,28,28,0,24,4,4,4,4,4,0,2,2,2,3,3,0,2023-12-20 20:58:00,0
5161,5161,5161,5161,2016,24,210,24,145,2016,65,24,125,120,117,24,24,210,65,28,28,0,24,4,4,4,4,4,6,2,2,2,5,5,0,2023-12-20 21:00:00,0
5168,5167,5169,5169,2017,24,209,24,148,2017,61,24,122,120,118,24,24,209,61,31,31,0,24,7,7,7,7,7,4,2,2,2,2,2,0,2023-12-20 21:02:00,0
5160,5160,5160,5160,2021,24,197,24,145,2021,52,24,121,119,118,24,24,197,52,28,28,0,24,4,4,4,4,4,2,2,2,2,2,2,0,2023-12-20 21:04:00,0
5166,5185,5166,5166,2023,22,201,22,144,2023,57,22,120,119,118,22,22,201,57,27,27,0,22,3,3,3,3,3,2,2,2,2,1,1,0,2023-12-20 21:06:00,0
5194,5194,5194,5194,2031,24,211,24,145,2031,66,24,123,118,118,24,24,211,66,28,28,0,24,4,4,4,4,3,0,2,2,2,5,5,1,2023-12-20 21:08:00,0
5187,5187,5187,5187,2022,24,223,24,148,2022,75,24,123,120,118,24,24,223,75,31,31,0,24,7,7,7,7,7,4,2,2,2,3,3,0,2023-12-20 21:10:00,0
5184,5184,5184,5184,2019,24,217,24,145,2019,72,24,125,119,118,24,24,217,72,28,28,0,24,4,4,4,4,3,2,2,2,2,6,6,1,2023-12-20 21:12:00,0
5177,5176,5176,5176,2024,24,211,24,145,2024,66,24,122,119,118,24,24,211,66,28,28,0,24,4,4,4,4,4,2,2,2,2,3,3,0,2023-12-20 21:14:00,0
5172,5173,5173,5173,2026,24,195,24,145,2026,50,24,127,122,118,24,24,195,50,28,28,0,24,4,4,4,4,4,8,2,2,2,5,5,0,2023-12-20 21:16:00,0
5169,5169,5169,5169,2026,24,195,24,148,2026,47,24,123,119,118,24,24,195,47,31,31,0,24,7,7,7,7,7,2,2,2,2,4,4,0,2023-12-20 21:18:00,0
5188,5185,5185,5185,2034,24,197,24,146,2034,51,24,123,120,118,24,24,197,51,28,28,0,24,4,4,4,4,4,4,2,2,2,3,3,0,2023-12-20 21:20:00,0
5140,5143,5143,5143,2002,24,212,24,144,2002,68,24,124,118,118,24,24,212,68,28,28,0,24,4,4,4,4,3,0,2,2,2,6,6,1,2023-12-20 21:22:00,0
5149,5148,5148,5148,2014,24,214,24,147,2014,67,24,122,118,118,24,24,214,67,31,31,0,24,7,7,7,7,7,0,2,2,2,4,4,0,2023-12-20 21:24:00,0
5192,5192,5192,5192,2040,24,192,24,145,2040,47,24,122,119,118,24,24,192,47,27,27,0,24,3,3,3,3,3,2,2,2,2,3,3,0,2023-12-20 21:26:00,0
5221,5222,5222,5222,2038,24,223,24,146,2038,77,24,123,122,119,24,24,223,77,28,28,0,24,4,4,4,4,3,6,2,2,2,1,1,1,2023-12-20 21:28:00,0
5165,5164,5164,5164,2017,24,205,24,144,2017,61,24,124,119,118,24,24,205,61,28,28,0,24,4,4,4,4,4,2,2,2,2,5,5,0,2023-12-20 21:30:00,0
5185,5186,5186,5186,2028,22,212,22,149,2028,63,22,124,122,118,22,22,212,63,31,31,0,22,7,7,7,7,7,8,2,2,2,2,2,0,2023-12-20 21:32:00,0
5162,5162,5162,5162,2023,24,192,24,145,2023,47,24,124,121,118,24,24,192,47,28,28,0,24,4,4,4,4,4,6,2,2,2,3,3,0,2023-12-20 21:34:00,0
5180,5179,5179,5179,2023,24,205,24,145,2023,60,24,124,120,119,24,24,205,60,28,28,0,24,4,4,4,4,4,2,2,2,2,4,4,0,2023-12-20 21:36:00,0
5170,5171,5171,5171,2017,24,216,24,147,2017,69,24,122,120,117,24,24,216,69,31,31,0,24,7,7,7,7,6,6,2,2,2,2,2,1,2023-12-20 21:38:00,0
5191,5192,5191,5191,2031,24,205,24,146,2031,59,24,124,120,119,24,24,205,59,28,28,0,24,4,4,4,4,4,2,2,2,2,4,4,0,2023-12-20 21:40:00,0
5190,5189,5189,5189,2018,24,227,24,144,2018,83,24,125,122,119,24,24,227,83,27,27,0,24,3,3,3,3,3,6,2,2,2,3,3,0,2023-12-20 21:42:00,0
5177,5177,5177,5177,2021,24,213,24,145,2021,68,24,122,119,118,24,24,213,68,28,28,0,24,4,4,4,4,3,2,2,2,2,3,3,1,2023-12-20 21:44:00,0
5207,5208,5208,5208,2029,24,230,24,149,2029,81,24,124,122,118,24,24,230,81,32,32,0,24,8,8,8,8,8,8,2,2,2,2,2,0,2023-12-20 21:46:00,0
5110,5110,5110,5110,2002,24,187,24,143,2002,44,24,121,119,118,24,24,187,44,27,27,0,24,3,3,3,3,3,2,2,2,2,2,2,0,2023-12-20 21:48:00,0
5211,5211,5211,5211,2037,24,274,24,147,2037,127,24,119,119,118,24,24,274,76,29,29,0,24,5,5,4,4,4,2,2,2,2,0,0,0,2023-12-20 21:50:00,52
5214,5213,5213,5213,2038,24,213,24,146,2038,67,24,124,121,120,24,24,213,67,28,28,0,24,4,4,4,4,4,2,2,2,2,3,3,0,2023-12-20 21:52:00,0
5164,5164,5164,5164,2019,24,207,24,147,2019,60,24,123,120,117,24,24,207,60,31,31,0,24,7,7,7,7,6,6,2,2,2,3,3,1,2023-12-20 21:54:00,0
5190,5188,5188,5188,2025,24,214,24,146,2025,68,24,123,118,118,24,24,214,68,28,28,0,24,4,4,4,4,4,0,2,2,2,5,5,0,2023-12-20 21:56:00,0
6763,6766,6766,6766,2636,28,286,28,187,2636,99,28,161,157,155,28,28,286,99,35,35,0,28,4,4,4,4,3,4,3,3,3,4,4,1,2023-12-20 21:58:00,0
5203,5203,5203,5203,2023,24,231,24,149,2023,82,24,123,118,118,24,24,231,82,31,31,0,24,7,7,7,7,7,0,2,2,2,5,5,0,2023-12-20 22:00:00,0
5161,5159,5161,5161,2019,24,202,24,145,2019,57,24,121,120,118,24,24,202,57,28,28,0,24,4,4,4,4,4,4,2,2,2,1,1,0,2023-12-20 22:02:00,0
5173,5172,5172,5172,2024,24,202,24,144,2024,58,24,122,120,119,24,24,202,58,27,27,0,24,3,3,3,3,3,2,2,2,2,2,2,0,2023-12-20 22:04:00,0
5205,5205,5205,5205,2029,24,222,24,145,2029,77,24,122,120,119,24,24,222,77,28,28,0,24,4,4,4,4,4,2,2,2,2,2,2,0,2023-12-20 22:06:00,0
5199,5197,5197,5197,2028,24,224,24,149,2028,75,24,126,119,118,24,24,224,75,31,31,0,24,7,7,7,7,7,2,2,2,2,7,7,0,2023-12-20 22:08:00,0
5181,5184,5184,5184,2024,24,208,24,145,2024,63,24,125,121,118,24,24,208,63,28,28,0,24,4,4,4,4,3,6,2,2,2,4,4,1,2023-12-20 22:10:00,0
5153,5153,5153,5153,2013,24,204,24,144,2013,60,24,123,120,118,24,24,204,60,28,28,0,24,4,4,4,4,4,4,2,2,2,3,3,0,2023-12-20 22:12:00,0
5182,5181,5181,5181,2028,24,205,24,148,2028,57,24,125,122,118,24,24,205,57,31,31,0,24,7,7,7,7,6,8,2,2,2,3,3,1,2023-12-20 22:14:00,0
5181,5181,5182,5181,2023,24,206,24,145,2023,61,24,125,123,119,24,24,206,61,28,28,0,24,4,4,4,4,4,8,2,2,2,2,2,0,2023-12-20 22:16:00,0
5191,5191,5190,5191,2030,24,211,24,146,2030,65,24,121,118,118,24,24,211,65,28,28,0,24,4,4,4,4,4,0,2,2,2,3,3,0,2023-12-20 22:18:00,0
5151,5152,5152,5152,2019,24,196,24,142,2019,54,24,122,118,118,24,24,196,54,26,26,0,24,3,3,3,3,3,0,2,2,2,4,4,0,2023-12-20 22:20:00,0
5159,5158,5158,5158,2011,22,222,22,149,2011,73,22,124,119,118,22,22,222,73,32,32,0,22,8,8,8,8,8,2,2,2,2,5,5,0,2023-12-20 22:22:00,0
5159,5160,5160,5160,2016,24,204,24,144,2016,60,24,122,119,118,24,24,204,60,27,27,0,24,3,3,3,3,3,2,2,2,2,3,3,0,2023-12-20 22:24:00,0
5218,5218,5218,5218,2040,24,214,24,146,2040,68,24,124,121,119,24,24,214,68,28,28,0,24,4,4,4,4,3,4,2,2,2,3,3,1,2023-12-20 22:26:00,0
5176,5175,5175,5175,2020,24,215,24,145,2020,70,24,123,118,118,24,24,215,70,28,28,0,24,4,4,4,4,4,0,2,2,2,5,5,0,2023-12-20 22:28:00,0
5186,5187,5187,5187,2024,24,220,24,149,2024,71,24,120,118,117,24,24,220,71,31,31,0,24,7,7,7,7,6,2,2,2,2,2,2,1,2023-12-20 22:30:00,0
5189,5188,5188,5188,2030,24,210,24,145,2030,65,24,125,120,119,24,24,210,65,28,28,0,24,4,4,4,4,4,2,2,2,2,5,5,0,2023-12-20 22:32:00,0
5165,5186,5166,5166,2020,24,197,24,145,2020,52,24,124,119,118,24,24,197,52,28,28,0,24,4,4,4,4,4,2,2,2,2,5,5,0,2023-12-20 22:34:00,0
5177,5177,5177,5177,2026,24,208,24,149,2026,59,24,122,119,118,24,24,208,59,31,31,4,24,7,7,7,7,7,2,2,2,2,3,3,0,2023-12-20 22:36:00,0
5218,5218,5218,5218,2039,24,219,24,146,2039,73,24,124,122,119,24,24,219,73,28,28,0,24,4,4,4,4,4,6,2,2,2,2,2,0,2023-12-20 22:38:00,0
5209,5209,5209,5209,2034,24,220,24,144,2034,76,24,123,119,118,24,24,220,76,27,27,0,24,3,3,3,3,3,2,2,2,2,4,4,0,2023-12-20 22:40:00,0
5154,5153,5153,5153,2011,24,208,24,145,2011,63,24,125,121,119,24,24,208,63,28,28,0,24,4,4,4,4,3,4,2,2,2,4,4,1,2023-12-20 22:42:00,0
5140,5141,5141,5141,2011,24,212,24,147,2011,65,24,120,118,117,24,24,212,65,31,31,0,24,7,7,7,7,7,2,2,2,2,2,2,0,2023-12-20 22:44:00,0
5192,5191,5191,5191,2026,24,220,23,148,2026,72,23,125,121,118,23,23,220,72,30,30,0,23,5,4,4,4,3,6,2,2,2,4,4,1,2023-12-20 22:46:00,3
5172,5191,5172,5172,2021,22,211,23,145,2021,66,23,124,120,118,23,23,211,66,28,28,0,23,4,4,4,4,4,4,2,2,2,4,4,0,2023-12-20 22:48:00,0
5181,5181,5181,5181,2029,24,253,24,147,2029,106,24,121,119,118,24,24,253,55,29,29,0,24,5,5,4,4,4,2,2,2,2,2,2,0,2023-12-20 22:50:00,52
5160,5161,5161,5161,2019,24,205,24,148,2019,57,24,120,119,118,24,24,205,57,31,31,0,24,7,7,7,7,7,2,2,2,2,1,1,0,2023-12-20 22:52:00,0
5187,5187,5187,5187,2029,24,207,24,146,2029,61,24,124,119,118,24,24,207,61,28,28,0,24,4,4,4,4,4,2,2,2,2,5,5,0,2023-12-20 22:54:00,0
5194,5194,5194,5194,2027,24,212,24,145,2027,67,24,128,121,118,24,24,212,67,28,28,10,24,4,4,4,4,3,6,2,2,2,7,7,1,2023-12-20 22:56:00,0
5170,5170,5170,5170,2015,24,213,24,148,2015,65,24,126,121,119,24,24,213,65,31,31,0,24,7,7,7,7,7,4,2,2,2,5,5,0,2023-12-20 22:58:00,0
5174,5174,5174,5174,2021,24,203,24,144,2021,59,24,126,120,118,24,24,203,59,27,27,0,24,3,3,3,3,3,4,2,2,2,6,6,0,2023-12-20 23:00:00,0
5162,5160,5162,5162,2010,24,216,24,145,2010,71,24,124,121,117,24,24,216,71,28,28,0,24,4,4,4,4,3,8,2,2,2,3,3,1,2023-12-20 23:02:00,0
5188,5187,5187,5187,2024,24,216,24,145,2024,71,24,124,120,119,24,24,216,71,28,28,0,24,4,4,4,4,4,2,2,2,2,4,4,0,2023-12-20 23:04:00,0
5202,5202,5202,5202,2028,24,221,24,149,2028,72,24,127,123,120,24,24,221,72,31,31,0,24,7,7,7,7,7,6,2,2,2,4,4,0,2023-12-20 23:06:00,0
5153,5154,5154,5154,2016,24,203,24,144,2016,59,24,126,120,117,24,24,203,59,28,28,0,24,4,4,4,4,4,6,2,2,2,6,6,0,2023-12-20 23:08:00,0
5205,5204,5204,5204,2030,24,218,24,146,2030,72,24,124,122,118,24,24,218,72,28,28,0,24,4,4,4,4,4,8,2,2,2,2,2,0,2023-12-20 23:10:00,0
5206,5206,5206,5206,2028,22,227,22,148,2028,79,22,126,123,118,22,22,227,79,31,31,0,22,7,7,7,7,6,10,2,2,2,3,3,1,2023-12-20 23:12:00,0
5198,5198,5198,5198,2025,24,226,24,145,2025,81,24,123,120,118,24,24,226,81,28,28,0,24,4,4,4,4,4,4,2,2,2,3,3,0,2023-12-20 23:14:00,0
5170,5170,5170,5170,2018,24,209,24,144,2018,65,24,122,118,118,24,24,209,65,27,27,0,24,3,3,3,3,3,0,2,2,2,4,4,0,2023-12-20 23:16:00,0
5194,5195,5195,5195,2035,24,208,24,146,2035,62,24,120,119,119,24,24,208,62,28,28,0,24,4,4,4,4,3,0,2,2,2,1,1,1,2023-12-20 23:18:00,0
5173,5173,5173,5173,2029,24,199,24,149,2029,50,24,120,118,118,24,24,199,50,32,32,0,24,8,8,8,8,8,0,2,2,2,2,2,0,2023-12-20 23:20:00,0
5149,5148,5148,5148,2015,24,195,24,144,2015,51,24,119,119,118,24,24,195,51,27,27,0,24,3,3,3,3,3,2,2,2,2,0,0,0,2023-12-20 23:22:00,0
5201,5202,5202,5202,2034,24,215,24,145,2034,70,24,123,120,119,24,24,215,70,28,28,0,24,4,4,4,4,4,2,2,2,2,3,3,0,2023-12-20 23:24:00,0
5172,5172,5172,5172,2023,24,202,24,145,2023,57,24,122,120,118,24,24,202,57,28,28,0,24,4,4,4,4,4,4,2,2,2,2,2,0,2023-12-20 23:26:00,0
5177,5176,5176,5176,2019,24,214,24,148,2019,66,24,124,122,118,24,24,214,66,31,31,0,24,7,7,7,7,6,8,2,2,2,2,2,1,2023-12-20 23:28:00,0
5144,5144,5144,5144,2015,24,204,24,145,2015,59,24,120,119,118,24,24,204,59,28,28,0,24,4,4,4,4,4,2,2,2,2,1,1,0,2023-12-20 23:30:00,0
5178,5179,5179,5179,2017,24,220,24,145,2017,75,24,120,119,118,24,24,220,75,28,28,0,24,4,4,4,4,3,2,2,2,2,1,1,1,2023-12-20 23:32:00,0
5183,5183,5183,5183,2022,24,216,24,148,2022,68,24,121,118,118,24,24,216,68,31,31,0,24,7,7,7,7,7,0,2,2,2,3,3,0,2023-12-20 23:34:00,0
5200,5200,5200,5200,2032,24,216,24,145,2032,71,24,124,122,118,24,24,216,71,28,28,0,24,4,4,4,4,4,8,2,2,2,2,2,0,2023-12-20 23:36:00,0
5145,5145,5145,5145,2016,22,194,22,144,2016,50,22,118,117,117,22,22,194,50,27,27,0,22,3,3,3,3,3,0,2,2,2,1,1,0,2023-12-20 23:38:00,0
5167,5167,5167,5167,2027,24,191,24,145,2027,46,24,125,121,118,24,24,191,46,28,28,0,24,4,4,4,4,4,6,2,2,2,4,4,0,2023-12-20 23:40:00,0
5173,5175,5173,5173,2017,24,217,24,148,2017,69,24,123,120,118,24,24,217,69,31,31,0,24,7,7,7,7,7,4,2,2,2,3,3,0,2023-12-20 23:42:00,0
5204,5204,5204,5204,2032,24,220,24,145,2032,75,24,123,119,119,24,24,220,75,28,28,0,24,4,4,4,4,3,0,2,2,2,4,4,1,2023-12-20 23:44:00,0
5188,5188,5188,5188,2031,24,202,24,145,2031,57,24,124,120,118,24,24,202,57,28,28,0,24,4,4,4,4,4,4,2,2,2,4,4,0,2023-12-20 23:46:00,0
5193,5191,5191,5191,2027,24,223,24,148,2027,75,24,122,120,119,24,24,223,75,31,31,0,24,7,7,7,7,6,2,2,2,2,2,2,1,2023-12-20 23:48:00,0
5188,5188,5188,5188,2029,24,263,24,147,2029,116,24,123,120,119,24,24,263,65,29,29,0,24,5,5,4,4,4,2,2,2,2,3,3,0,2023-12-20 23:50:00,52
5189,5191,5191,5191,2029,24,207,24,145,2029,62,24,120,118,118,24,24,207,62,28,28,0,24,4,4,4,4,4,0,2,2,2,2,2,0,2023-12-20 23:52:00,0
5128,5126,5126,5126,2007,24,199,24,143,2007,56,24,121,118,117,24,24,199,56,27,27,0,24,3,3,3,3,3,2,2,2,2,3,3,0,2023-12-20 23:54:00,0
5204,5205,5205,5205,2029,24,225,24,150,2029,75,24,125,120,119,24,24,225,75,32,32,0,24,8,8,8,8,8,2,2,2,2,5,5,0,2023-12-20 23:56:00,0
5194,5196,5195,5195,2026,24,216,24,144,2026,72,24,126,120,119,24,24,216,72,27,27,0,24,3,3,3,3,3,2,2,2,2,6,6,0,2023-12-20 23:58:00,0
5197,5197,5197,5197,2034,24,204,24,145,2034,59,24,123,119,118,24,24,204,59,28,28,0,24,4,4,4,4,3,2,2,2,2,4,4,1,2023-12-21 00:00:00,0
5170,5169,5169,5169,2020,24,204,24,146,2020,58,24,125,122,118,24,24,204,58,28,28,0,24,4,4,4,4,4,8,2,2,2,3,3,0,2023-12-21 00:02:00,0
5174,5175,5175,5175,2025,22,207,22,148,2025,59,22,123,121,118,22,22,207,59,31,31,0,22,7,7,7,7,6,6,2,2,2,2,2,1,2023-12-21 00:04:00,0
5192,5191,5191,5191,2028,24,218,24,145,2028,73,24,126,124,119,24,24,218,73,28,28,0,24,4,4,4,4,4,10,2,2,2,2,2,0,2023-12-21 00:06:00,0
5182,5183,5183,5183,2024,24,216,24,145,2024,71,24,122,118,118,24,24,216,71,28,28,0,24,4,4,4,4,4,0,2,2,2,4,4,0,2023-12-21 00:08:00,0
5173,5173,5173,5173,2028,24,200,24,148,2028,52,24,123,118,118,24,24,200,52,31,31,0,24,7,7,7,7,7,0,2,2,2,5,5,0,2023-12-21 00:10:00,0
5201,5201,5201,5201,2027,24,223,24,145,2027,78,24,124,119,118,24,24,223,78,28,28,0,24,4,4,4,4,4,2,2,2,2,5,5,0,2023-12-21 00:12:00,0
5175,5175,5175,5175,2019,24,218,24,144,2019,74,24,124,120,118,24,24,218,74,27,27,0,24,3,3,3,3,3,4,2,2,2,4,4,0,2023-12-21 00:14:00,0
5166,5165,5165,5165,2023,24,201,24,145,2023,56,24,120,119,118,24,24,201,56,28,28,0,24,4,4,4,4,3,2,2,2,2,1,1,1,2023-12-21 00:16:00,0
5137,5138,5138,5138,2007,24,215,24,147,2007,68,24,121,118,118,24,24,215,68,31,31,0,24,7,7,7,7,7,0,2,2,2,3,3,0,2023-12-21 00:18:00,0
5143,5142,5143,5143,2021,24,181,24,145,2021,36,24,121,119,118,24,24,181,36,28,28,0,24,4,4,4,4,3,2,2,2,2,2,2,1,2023-12-21 00:20:00,0
5148,5149,5148,5148,2017,24,196,24,145,2017,51,24,119,119,118,24,24,196,51,28,28,0,24,4,4,4,4,4,2,2,2,2,0,0,0,2023-12-21 00:22:00,0
5179,5179,5179,5179,2033,24,196,24,148,2033,48,24,126,119,118,24,24,196,48,31,31,0,24,7,7,7,7,7,2,2,2,2,7,7,0,2023-12-21 00:24:00,0
5226,5225,5225,5225,2038,24,224,24,146,2038,78,24,126,122,119,24,24,224,78,28,28,0,24,4,4,4,4,4,6,2,2,2,4,4,0,2023-12-21 00:26:00,0
5202,5203,5203,5203,2033,24,215,24,146,2033,69,24,123,119,119,24,24,215,69,28,28,0,24,4,4,4,4,4,0,2,2,2,4,4,0,2023-12-21 00:28:00,0
5173,5172,5172,5172,2020,22,212,22,145,2020,67,22,126,120,118,22,22,212,67,28,28,0,22,4,4,4,4,3,4,2,2,2,6,6,1,2023-12-21 00:30:00,0
5172,5174,5173,5173,2017,24,221,24,147,2017,74,24,122,119,117,24,24,221,74,31,31,0,24,7,7,7,7,7,4,2,2,2,3,3,0,2023-12-21 00:32:00,0
5168,5167,5167,5167,2025,24,202,24,144,2025,58,24,122,122,118,24,24,202,58,27,27,0,24,3,3,3,3,3,8,2,2,2,0,0,0,2023-12-21 00:34:00,0
5186,5185,5185,5185,2023,24,216,24,145,2023,71,24,123,120,118,24,24,216,71,28,28,0,24,4,4,4,4,3,4,2,2,2,3,3,1,2023-12-21 00:36:00,0
5208,5210,5210,5210,2039,24,210,24,146,2039,64,24,124,122,120,24,24,210,64,28,28,0,24,4,4,4,4,4,4,2,2,2,2,2,0,2023-12-21 00:38:00,0
5143,5142,5142,5142,2018,24,199,24,147,2018,52,24,124,120,117,24,24,199,52,31,31,0,24,7,7,7,7,7,6,2,2,2,4,4,0,2023-12-21 00:40:00,0
5185,5186,5186,5186,2026,24,218,24,147,2026,71,24,122,119,118,24,24,218,71,29,29,0,24,4,4,4,4,4,2,2,2,2,3,3,0,2023-12-21 00:42:00,2
5183,5182,5182,5182,2020,24,217,24,144,2020,73,24,126,120,118,24,24,217,73,28,28,0,24,4,4,4,4,4,4,2,2,2,6,6,0,2023-12-21 00:44:00,0
5203,5204,5204,5204,2023,24,238,24,148,2023,90,24,125,121,118,24,24,238,90,31,31,0,24,7,7,7,7,6,6,2,2,2,4,4,1,2023-12-21 00:46:00,0
5198,5197,5197,5197,2029,24,217,24,146,2029,71,24,125,120,118,24,24,217,71,28,28,0,24,4,4,4,4,4,4,2,2,2,5,5,0,2023-12-21 00:48:00,0
5193,5214,5193,5193,2030,24,261,24,145,2030,116,24,121,119,118,24,24,261,65,28,28,0,24,4,4,3,3,3,2,2,2,2,2,2,0,2023-12-21 00:50:00,52
5182,5183,5183,5183,2032,24,200,24,146,2032,54,24,122,119,119,24,24,200,54,28,28,0,24,4,4,4,4,3,0,2,2,2,3,3,1,2023-12-21 00:52:00,0
5187,5187,5187,5187,2029,24,209,24,149,2029,60,24,126,120,118,24,24,209,60,32,32,0,24,8,8,8,8,8,4,2,2,2,6,6,0,2023-12-21 00:54:00,0
5172,5171,5171,5171,2019,24,207,23,144,2019,63,23,125,122,118,23,23,207,63,27,27,0,23,3,3,3,3,3,8,2,2,2,3,3,0,2023-12-21 00:56:00,0
5200,5200,5200,5200,2035,22,210,23,146,2035,64,23,125,122,119,23,23,210,64,28,28,0,23,4,4,4,4,4,6,2,2,2,3,3,0,2023-12-21 00:58:00,0
5178,5178,5178,5178,2027,24,205,24,148,2027,57,24,122,119,118,24,24,205,57,31,31,0,24,7,7,7,7,7,2,2,2,2,3,3,0,2023-12-21 01:00:00,0
5181,5181,5181,5181,2021,24,313,24,145,2021,168,24,123,122,119,24,24,313,168,28,28,0,24,4,4,4,4,3,6,2,2,2,1,1,1,2023-12-21 01:02:00,0
5147,5148,5148,5148,2014,24,201,24,144,2014,57,24,122,120,117,24,24,201,57,27,27,0,24,4,4,4,4,4,6,2,2,2,2,2,0,2023-12-21 01:04:00,0
5161,5180,5160,5160,2020,24,205,24,145,2020,60,24,120,118,118,24,24,205,60,28,28,4,24,4,4,4,4,3,0,2,2,2,2,2,1,2023-12-21 01:06:00,0
5164,5165,5165,5165,2018,24,200,24,147,2018,53,24,129,121,118,24,24,200,53,31,31,0,24,7,7,7,7,7,6,2,2,2,8,8,0,2023-12-21 01:08:00,0
5191,5192,5191,5191,2029,24,218,24,145,2029,73,24,125,121,118,24,24,218,73,28,28,0,24,4,4,4,4,4,6,2,2,2,4,4,0,2023-12-21 01:10:00,0
5184,5184,5184,5184,2024,24,211,24,144,2024,67,24,123,120,118,24,24,211,67,27,27,0,24,3,3,3,3,3,4,2,2,2,3,3,0,2023-12-21 01:12:00,0
5165,5165,5165,5165,2021,24,199,24,145,2021,54,24,125,121,118,24,24,199,54,28,28,0,24,4,4,4,4,4,6,2,2,2,4,4,0,2023-12-21 01:14:00,0
5189,5189,5189,5189,2026,24,216,24,148,2026,68,24,123,120,118,24,24,216,68,31,31,0,24,7,7,7,7,7,4,2,2,2,3,3,0,2023-12-21 01:16:00,0
5173,5172,5172,5172,2028,24,202,24,145,2028,57,24,123,119,118,24,24,202,57,28,28,0,24,4,4,4,4,3,2,2,2,2,4,4,1,2023-12-21 01:18:00,0
5181,5179,5179,5179,2021,24,218,24,145,2021,73,24,122,122,119,24,24,218,73,28,28,0,24,4,4,4,4,4,6,2,2,2,0,0,0,2023-12-21 01:20:00,0
5187,5190,5190,5190,2026,23,222,23,148,2026,74,23,126,124,119,23,23,222,74,31,31,0,23,7,7,7,7,6,10,2,2,2,2,2,1,2023-12-21 01:22:00,0
5169,5170,5169,5169,2028,23,193,23,145,2028,48,23,121,119,118,23,23,193,48,28,28,0,23,4,4,4,4,4,2,2,2,2,2,2,0,2023-12-21 01:24:00,0
5140,5140,5140,5140,2006,24,216,24,144,2006,72,24,123,119,117,24,24,216,72,28,28,0,24,4,4,4,4,4,4,2,2,2,4,4,0,2023-12-21 01:26:00,0
5179,5178,5178,5178,2014,24,231,24,143,2014,88,24,121,118,117,24,24,231,88,27,27,0,24,3,3,3,3,3,2,2,2,2,3,3,0,2023-12-21 01:28:00,0
5203,5203,5203,5203,2034,24,219,24,150,2034,69,24,124,119,118,24,24,219,69,32,32,0,24,8,8,8,8,8,2,2,2,2,5,5,0,2023-12-21 01:30:00,0
5180,5180,5180,5180,2023,24,214,24,144,2023,70,24,121,119,118,24,24,214,70,27,27,0,24,3,3,3,3,3,2,2,2,2,2,2,0,2023-12-21 01:32:00,0
5192,5193,5193,5193,2026,24,218,24,145,2026,73,24,121,120,118,24,24,218,73,28,28,0,24,4,4,4,4,3,4,2,2,2,1,1,1,2023-12-21 01:34:00,0
5192,5191,5191,5191,2027,24,216,24,148,2027,68,24,126,124,119,24,24,216,68,31,31,0,24,7,7,7,7,7,10,2,2,2,2,2,0,2023-12-21 01:36:00,0
5198,5197,5197,5197,2037,24,203,24,146,2037,57,24,122,119,119,24,24,203,57,28,28,0,24,4,4,4,4,3,0,2,2,2,3,3,1,2023-12-21 01:38:00,0
5182,5183,5183,5183,2024,24,215,24,144,2024,71,24,122,120,118,24,24,215,71,28,28,0,24,4,4,4,4,4,4,2,2,2,2,2,0,2023-12-21 01:40:00,0
5166,5167,5167,5167,2014,24,212,24,145,2014,67,24,124,120,117,24,24,212,67,28,28,0,24,4,4,4,4,4,6,2,2,2,4,4,0,2023-12-21 01:42:00,0
5173,5172,5172,5172,2024,24,204,24,148,2024,56,24,125,120,118,24,24,204,56,31,31,0,24,7,7,7,7,7,4,2,2,2,5,5,0,2023-12-21 01:44:00,0
5183,5184,5184,5184,2021,24,219,24,145,2021,74,24,125,120,118,24,24,219,74,28,28,0,24,4,4,4,4,4,4,2,2,2,5,5,0,2023-12-21 01:46:00,0
5190,5189,5189,5189,2022,23,226,22,144,2022,82,22,121,119,118,22,22,226,82,27,27,0,22,3,3,3,3,3,2,2,2,2,2,2,0,2023-12-21 01:48:00,0
5141,5142,5142,5142,2005,23,268,24,145,2005,123,24,124,120,117,24,24,268,72,29,29,0,24,5,5,4,4,3,6,2,2,2,4,4,1,2023-12-21 01:50:00,52
5182,5182,5182,5182,2032,24,201,24,148,2032,53,24,123,120,118,24,24,201,53,31,31,0,24,7,7,7,7,7,4,2,2,2,3,3,0,2023-12-21 01:52:00,0
5192,5190,5190,5190,2030,24,215,24,145,2030,70,24,121,118,118,24,24,215,70,28,28,0,24,4,4,4,4,3,0,2,2,2,3,3,1,2023-12-21 01:54:00,0
5200,5201,5201,5201,2032,24,216,24,146,2032,70,24,125,121,119,24,24,216,70,28,28,0,24,4,4,4,4,4,4,2,2,2,4,4,0,2023-12-21 01:56:00,0
5170,5171,5171,5171,2017,24,223,24,148,2017,75,24,122,119,117,24,24,223,75,31,31,0,24,7,7,7,7,7,4,2,2,2,3,3,0,2023-12-21 01:58:00,0
5181,5180,5180,5180,2030,24,199,24,145,2030,54,24,124,119,118,24,24,199,54,28,28,0,24,4,4,4,4,4,2,2,2,2,5,5,0,2023-12-21 02:00:00,0
5174,5174,5175,5175,2012,24,225,24,145,2012,80,24,126,123,118,24,24,225,80,28,28,0,24,4,4,4,4,4,10,2,2,2,3,3,0,2023-12-21 02:02:00,0
5161,5160,5160,5160,2030,24,183,24,145,2030,38,24,124,118,118,24,24,183,38,28,28,0,24,4,4,4,4,3,0,2,2,2,6,6,1,2023-12-21 02:04:00,0
5175,5176,5176,5176,2026,24,213,24,149,2026,64,24,122,119,118,24,24,213,64,32,32,0,24,7,7,7,7,7,2,2,2,2,3,3,0,2023-12-21 02:06:00,3
5197,5197,5197,5197,2032,24,215,24,146,2032,69,24,122,121,118,24,24,215,69,28,28,0,24,3,3,3,3,3,6,2,2,2,1,1,0,2023-12-21 02:08:00,2
5190,5208,5189,5189,2033,24,202,24,145,2033,57,24,120,119,119,24,24,202,57,28,28,0,24,4,4,4,4,3,0,2,2,2,1,1,1,2023-12-21 02:10:00,0
5179,5177,5177,5177,2018,23,226,23,145,2018,81,23,121,121,118,23,23,226,81,28,28,0,23,4,4,4,4,4,6,2,2,2,0,0,0,2023-12-21 02:12:00,0
5162,5165,5165,5165,2020,23,215,23,148,2020,67,23,122,120,118,23,23,215,67,31,31,0,23,7,7,7,7,7,4,2,2,2,2,2,0,2023-12-21 02:14:00,0
5187,5187,5187,5187,2027,24,212,24,145,2027,67,24,125,120,118,24,24,212,67,28,28,0,24,4,4,4,4,4,4,2,2,2,5,5,0,2023-12-21 02:16:00,0
5178,5177,5177,5177,2028,24,207,24,145,2028,62,24,121,119,119,24,24,207,62,28,28,0,24,4,4,4,4,4,0,2,2,2,2,2,0,2023-12-21 02:18:00,0
5177,5177,5177,5177,2033,24,192,24,149,2033,43,24,127,119,118,24,24,192,43,31,31,0,24,7,7,7,7,6,2,2,2,2,8,8,1,2023-12-21 02:20:00,0
5137,5138,5138,5138,2005,24,201,24,144,2005,57,24,123,120,119,24,24,201,57,28,28,0,24,4,4,4,4,4,2,2,2,2,3,3,0,2023-12-21 02:22:00,0
5205,5204,5204,5204,2034,24,217,24,145,2034,72,24,122,120,118,24,24,217,72,27,27,0,24,3,3,3,3,3,4,2,2,2,2,2,0,2023-12-21 02:24:00,0
5185,5186,5186,5186,2028,24,211,24,145,2028,66,24,124,122,120,24,24,211,66,28,28,0,24,4,4,4,4,3,4,2,2,2,2,2,1,2023-12-21 02:26:00,0
5161,5161,5161,5161,2017,24,206,24,149,2017,57,24,126,121,118,24,24,206,57,32,32,0,24,8,8,8,8,8,6,2,2,2,5,5,0,2023-12-21 02:28:00,0
5160,5160,5160,5160,2021,24,203,24,144,2021,59,24,120,119,118,24,24,203,59,27,27,0,24,3,3,3,3,3,2,2,2,2,1,1,0,2023-12-21 02:30:00,0
5173,5173,5173,5173,2022,24,208,24,145,2022,63,24,121,120,119,24,24,208,63,28,28,0,24,4,4,4,4,4,2,2,2,2,1,1,0,2023-12-21 02:32:00,0
5175,5175,5175,5175,2018,24,220,24,147,2018,73,24,123,121,118,24,24,220,73,31,31,0,24,7,7,7,7,7,6,2,2,2,2,2,0,2023-12-21 02:34:00,0
5170,5169,5169,5169,2021,24,208,24,145,2021,63,24,124,121,118,24,24,208,63,28,28,0,24,4,4,4,4,3,6,2,2,2,3,3,1,2023-12-21 02:36:00,0
5138,5138,5138,5138,2015,22,189,22,145,2015,44,22,126,124,117,22,22,189,44,28,28,0,22,4,4,4,4,4,14,2,2,2,2,2,0,2023-12-21 02:38:00,0
5189,5190,5190,5190,2024,24,221,24,145,2024,76,24,121,121,119,24,24,221,76,28,28,0,24,4,4,4,4,3,4,2,2,2,0,0,1,2023-12-21 02:40:00,0
5155,5154,5154,5154,2010,24,211,24,147,2010,64,24,125,122,119,24,24,211,64,31,31,0,24,7,7,7,7,7,6,2,2,2,3,3,0,2023-12-21 02:42:00,0
5183,5184,5184,5184,2026,24,211,24,146,2026,65,24,121,118,118,24,24,211,65,28,28,0,24,4,4,4,4,4,0,2,2,2,3,3,0,2023-12-21 02:44:00,0
5184,5184,5184,5184,2024,24,214,24,143,2024,71,24,125,121,118,24,24,214,71,27,27,0,24,3,3,3,3,3,6,2,2,2,4,4,0,2023-12-21 02:46:00,0
5161,5160,5160,5160,2018,24,194,24,145,2018,49,24,124,120,118,24,24,194,49,28,28,0,24,4,4,4,4,4,4,2,2,2,4,4,0,2023-12-21 02:48:00,0
5195,5196,5196,5196,2030,24,219,24,148,2030,71,24,123,121,118,24,24,219,71,31,31,0,24,7,7,7,7,7,6,2,2,2,2,2,0,2023-12-21 02:50:00,0
5180,5179,5179,5179,2020,24,216,24,145,2020,71,24,122,119,118,24,24,216,71,28,28,0,24,4,4,4,4,3,2,2,2,2,3,3,1,2023-12-21 02:52:00,0
5180,5181,5181,5181,2021,24,212,24,145,2021,67,24,123,120,118,24,24,212,67,28,28,0,24,4,4,4,4,4,4,2,2,2,3,3,0,2023-12-21 02:54:00,0
5176,5194,5175,5175,2029,24,202,24,148,2029,54,24,121,119,118,24,24,202,54,31,31,0,24,7,7,7,7,6,2,2,2,2,2,2,1,2023-12-21 02:56:00,0
5176,5177,5177,5177,2017,24,217,24,145,2017,72,24,123,120,119,24,24,217,72,28,28,0,24,4,4,4,4,4,2,2,2,2,3,3,0,2023-12-21 02:58:00,0
5122,5122,5122,5122,2006,24,201,24,144,2006,57,24,122,119,118,24,24,201,57,28,28,0,24,4,4,4,4,4,2,2,2,2,3,3,0,2023-12-21 03:00:00,0
5158,5158,5158,5158,2006,23,221,23,144,2006,77,23,123,118,117,23,23,221,77,27,27,0,23,3,3,3,3,3,2,2,2,2,5,5,0,2023-12-21 03:02:00,0
5198,5197,5197,5197,2033,23,315,23,149,2033,166,23,126,121,119,23,23,315,166,32,32,0,23,8,8,8,8,8,4,2,2,2,5,5,0,2023-12-21 03:04:00,0
5198,5198,5198,5198,2028,24,221,24,145,2028,76,24,119,118,118,24,24,221,76,27,27,0,24,3,3,3,3,3,0,2,2,2,1,1,0,2023-12-21 03:06:00,0
5170,5171,5171,5171,2025,24,204,24,144,2025,60,24,121,118,117,24,24,204,60,28,28,0,24,4,4,4,4,3,2,2,2,2,3,3,1,2023-12-21 03:08:00,0
5193,5192,5192,5192,2025,24,223,24,148,2025,75,24,125,119,118,24,24,223,75,31,31,0,24,7,7,7,7,7,2,2,2,2,6,6,0,2023-12-21 03:10:00,0
5173,5174,5174,5174,2025,24,202,24,146,2025,56,24,121,120,118,24,24,202,56,28,28,0,24,4,4,4,4,3,4,2,2,2,1,1,1,2023-12-21 03:12:00,0
5175,5175,5175,5175,2032,24,195,24,145,2032,50,24,123,120,118,24,24,195,50,28,28,0,24,4,4,4,4,4,4,2,2,2,3,3,0,2023-12-21 03:14:00,0
5190,5190,5190,5190,2039,24,197,24,146,2039,51,24,122,121,119,24,24,197,51,28,28,0,24,4,4,4,4,4,4,2,2,2,1,1,0,2023-12-21 03:16:00,0
5161,5160,5160,5160,2024,24,195,24,148,2024,47,24,122,120,118,24,24,195,47,31,31,0,24,7,7,7,7,7,4,2,2,2,2,2,0,2023-12-21 03:18:00,0
5161,5162,5162,5162,2028,24,184,24,145,2028,39,24,120,118,118,24,24,184,39,28,28,0,24,4,4,4,4,4,0,2,2,2,2,2,0,2023-12-21 03:20:00,0
5126,5146,5126,5126,2008,24,189,24,144,2008,45,24,120,118,117,24,24,189,45,28,28,0,24,4,4,4,4,3,2,2,2,2,2,2,1,2023-12-21 03:22:00,0
5152,5151,5151,5151,2014,24,210,24,144,2014,66,24,121,119,119,24,24,210,66,27,27,0,24,3,3,3,3,3,0,2,2,2,2,2,0,2023-12-21 03:24:00,0
5162,5161,5161,5161,2013,24,211,24,147,2013,64,24,128,122,119,24,24,211,64,31,31,0,24,7,7,7,7,7,6,2,2,2,6,6,0,2023-12-21 03:26:00,0
5192,5194,5194,5194,2030,23,207,23,146,2030,61,23,128,123,120,23,23,207,61,28,28,0,23,4,4,4,4,3,6,2,2,2,5,5,1,2023-12-21 03:28:00,0
5192,5192,5192,5192,2036,23,204,23,145,2036,59,23,120,119,119,23,23,204,59,28,28,0,23,4,4,4,4,4,0,2,2,2,1,1,0,2023-12-21 03:30:00,0
5165,5165,5165,5165,2020,24,205,24,148,2020,57,24,124,120,118,24,24,205,57,31,31,0,24,7,7,7,7,7,4,2,2,2,4,4,0,2023-12-21 03:32:00,0
5172,5171,5171,5171,2028,24,203,24,145,2028,58,24,120,119,118,24,24,203,58,28,28,0,24,4,4,4,4,4,2,2,2,2,1,1,0,2023-12-21 03:34:00,0
5168,5168,5168,5168,2021,24,199,24,145,2021,54,24,125,118,117,24,24,199,54,28,28,0,24,4,4,4,4,4,2,2,2,2,7,7,0,2023-12-21 03:36:00,0
5177,5177,5177,5177,2021,24,212,24,145,2021,67,24,126,119,119,24,24,212,67,28,28,0,24,4,4,4,4,3,0,2,2,2,7,7,1,2023-12-21 03:38:00,0
5183,5183,5183,5183,2022,24,221,24,148,2022,73,24,118,118,118,24,24,221,73,31,31,0,24,7,7,7,7,7,0,2,2,2,0,0,0,2023-12-21 03:40:00,0
5191,5192,5192,5192,2024,24,224,24,145,2024,79,24,121,119,118,24,24,224,79,27,27,0,24,3,3,3,3,3,2,2,2,2,2,2,0,2023-12-21 03:42:00,0
5189,5189,5189,5189,2029,24,216,24,145,2029,71,24,121,119,118,24,24,216,71,28,28,0,24,4,4,4,4,3,2,2,2,2,2,2,1,2023-12-21 03:44:00,0
5215,5234,5215,5215,2038,24,226,24,150,2038,76,24,125,121,119,24,24,226,76,32,32,0,24,8,8,8,8,8,4,2,2,2,4,4,0,2023-12-21 03:46:00,0
5199,5199,5199,5199,2029,24,216,24,144,2029,72,24,123,120,118,24,24,216,72,27,27,0,24,3,3,3,3,3,4,2,2,2,3,3,0,2023-12-21 03:48:00,0
5148,5147,5147,5147,2007,24,273,24,144,2007,129,24,120,118,117,24,24,273,78,28,28,0,24,5,5,4,4,4,2,2,2,2,2,2,0,2023-12-21 03:50:00,52
5184,5186,5185,5185,2019,24,221,24,145,2019,76,24,126,122,118,24,24,221,76,28,28,0,24,4,4,4,4,4,8,2,2,2,4,4,0,2023-12-21 03:52:00,0
5187,5187,5187,5187,2026,22,219,22,148,2026,71,22,125,119,119,22,22,219,71,31,31,0,22,7,7,7,7,6,0,2,2,2,6,6,1,2023-12-21 03:54:00,0
5163,5161,5161,5161,2018,24,202,24,145,2018,57,24,123,121,118,24,24,202,57,28,28,0,24,4,4,4,4,4,6,2,2,2,2,2,0,2023-12-21 03:56:00,0
5178,5179,5179,5179,2026,24,207,24,145,2026,62,24,121,118,117,24,24,207,62,28,28,0,24,4,4,4,4,3,2,2,2,2,3,3,1,2023-12-21 03:58:00,0
5191,5193,5192,5192,2026,24,215,24,144,2026,71,24,127,121,119,24,24,215,71,27,27,0,24,3,3,3,3,3,4,2,2,2,6,6,0,2023-12-21 04:00:00,0
5193,5212,5193,5193,2017,24,347,24,154,2017,193,24,127,121,119,24,24,347,193,37,37,0,24,8,8,8,8,8,4,2,2,2,6,6,0,2023-12-21 04:02:00,13
5179,5179,5179,5179,2016,24,234,24,144,2016,90,24,119,117,117,24,24,234,90,27,27,0,24,3,3,3,3,3,0,2,2,2,2,2,0,2023-12-21 04:04:00,0
5226,5225,5225,5225,2034,24,235,24,145,2034,90,24,128,121,118,24,24,235,90,28,28,0,24,4,4,4,4,4,6,2,2,2,7,7,0,2023-12-21 04:06:00,0
5164,5164,5164,5164,2020,24,210,24,148,2020,62,24,123,118,118,24,24,210,62,31,31,0,24,7,7,7,7,7,0,2,2,2,5,5,0,2023-12-21 04:08:00,0
5177,5178,5178,5178,2023,24,210,24,146,2023,64,24,123,120,118,24,24,210,64,29,29,0,24,4,4,4,4,3,4,2,2,2,3,3,1,2023-12-21 04:10:00,0
5187,5187,5187,5187,2021,24,226,24,145,2021,81,24,126,122,118,24,24,226,81,28,28,0,24,4,4,4,4,4,8,2,2,2,4,4,0,2023-12-21 04:12:00,0
5137,5136,5136,5136,2004,24,216,24,143,2004,73,24,120,118,117,24,24,216,73,27,27,0,24,4,4,4,4,3,2,2,2,2,2,2,1,2023-12-21 04:14:00,0
5175,5176,5176,5176,2028,24,205,24,148,2028,57,24,124,120,119,24,24,205,57,31,31,0,24,7,7,7,7,7,2,2,2,2,4,4,0,2023-12-21 04:16:00,0
5205,5205,5205,5205,2034,22,217,22,146,2034,71,22,122,120,118,22,22,217,71,28,28,0,22,4,4,4,4,4,4,2,2,2,2,2,0,2023-12-21 04:18:00,0
5203,5203,5203,5203,2039,24,203,24,145,2039,58,24,125,121,119,24,24,203,58,27,27,0,24,3,3,3,3,3,4,2,2,2,4,4,0,2023-12-21 04:20:00,0
5160,5160,5160,5160,2015,24,206,24,149,2015,57,24,127,121,118,24,24,206,57,32,32,0,24,8,8,8,8,8,6,2,2,2,6,6,0,2023-12-21 04:22:00,0
5183,5183,5183,5183,2030,24,200,24,144,2030,56,24,123,121,119,24,24,200,56,27,27,0,24,3,3,3,3,3,4,2,2,2,2,2,0,2023-12-21 04:24:00,0
5185,5203,5184,5184,2023,24,218,24,145,2023,73,24,122,120,119,24,24,218,73,28,28,0,24,4,4,4,4,3,2,2,2,2,2,2,1,2023-12-21 04:26:00,0
5168,5169,5169,5169,2019,24,210,24,144,2019,66,24,123,120,117,24,24,210,66,28,28,0,24,4,4,4,4,4,6,2,2,2,3,3,0,2023-12-21 04:28:00,0
5206,5206,5206,5206,2033,24,223,24,149,2033,74,24,123,120,119,24,24,223,74,31,31,0,24,7,7,7,7,6,2,2,2,2,3,3,1,2023-12-21 04:30:00,0
5199,5198,5198,5198,2031,24,216,24,146,2031,70,24,121,119,119,24,24,216,70,28,28,0,24,4,4,4,4,4,0,2,2,2,2,2,0,2023-12-21 04:32:00,0
5171,5171,5171,5171,2018,24,214,24,144,2018,70,24,124,120,118,24,24,214,70,28,28,0,24,4,4,4,4,4,4,2,2,2,4,4,0,2023-12-21 04:34:00,0
5137,5138,5138,5138,2005,24,212,24,143,2005,69,24,122,118,117,24,24,212,69,27,27,0,24,3,3,3,3,3,2,2,2,2,4,4,0,2023-12-21 04:36:00,0
5207,5207,5207,5207,2029,24,227,24,150,2029,77,24,129,122,118,24,24,227,77,32,32,0,24,8,8,8,8,8,8,2,2,2,7,7,0,2023-12-21 04:38:00,0
5186,5186,5186,5186,2024,24,213,24,144,2024,69,24,124,120,118,24,24,213,69,27,27,0,24,3,3,3,3,3,4,2,2,2,4,4,0,2023-12-21 04:40:00,0
5152,5152,5152,5152,2016,30,202,25,145,2017,57,25,122,119,118,25,24,202,57,28,28,0,24,4,4,4,4,3,2,2,2,2,3,3,1,2023-12-21 04:42:00,2
5187,5188,5187,5187,2031,22,209,22,148,2031,61,22,123,120,118,22,22,209,61,31,31,0,22,7,7,7,7,7,4,2,2,2,3,3,0,2023-12-21 04:44:00,0
5195,5195,5195,5195,2036,24,212,24,146,2036,66,24,122,119,118,24,24,212,66,28,28,0,24,4,4,4,4,3,2,2,2,2,3,3,1,2023-12-21 04:46:00,0
5181,5181,5181,5181,2023,24,218,24,145,2023,73,24,122,120,119,24,24,218,73,28,28,0,24,4,4,4,4,4,2,2,2,2,2,2,0,2023-12-21 04:48:00,0
5207,5226,5207,5207,2029,24,278,24,146,2029,132,24,127,123,118,24,24,278,81,29,29,0,24,5,5,4,4,4,10,2,2,2,4,4,0,2023-12-21 04:50:00,52
5517,5517,5517,5517,2027,64,253,64,187,2027,66,64,179,177,175,64,64,253,66,31,31,0,64,7,7,7,7,7,4,2,2,2,2,2,0,2023-12-21 04:52:00,0
5635,5635,5635,5635,2028,84,292,84,208,2028,84,84,190,186,183,84,84,292,84,28,28,0,84,4,4,4,4,4,6,2,2,2,4,4,0,2023-12-21 04:54:00,0
5678,5699,5678,5678,2026,103,301,103,222,2026,79,103,190,189,184,103,103,301,79,28,28,0,103,4,4,4,4,3,10,2,2,2,1,1,1,2023-12-21 04:56:00,0
5645,5644,5644,5644,2025,83,298,83,224,2025,74,83,189,184,182,83,83,298,74,31,31,0,83,7,7,7,7,7,4,2,2,2,5,5,0,2023-12-21 04:58:00,0
5595,5596,5596,5596,2007,96,275,96,201,2007,74,96,196,192,191,96,96,275,74,27,27,0,96,3,3,3,3,3,2,2,2,2,4,4,0,2023-12-21 05:00:00,0
5636,5635,5635,5635,2019,98,373,98,203,2019,170,98,193,188,184,98,98,373,170,28,28,0,98,4,4,4,4,3,8,2,2,2,5,5,1,2023-12-21 05:02:00,0
5683,5683,5683,5683,2030,86,283,86,216,2030,67,86,204,199,196,86,86,283,67,28,28,0,86,4,4,4,4,4,6,2,2,2,5,5,0,2023-12-21 05:04:00,0
5649,5650,5650,5650,2022,94,293,94,223,2022,70,94,193,187,186,94,94,293,70,31,31,0,94,7,7,7,7,7,2,2,2,2,6,6,0,2023-12-21 05:06:00,0
5677,5675,5675,5675,2034,100,271,100,213,2034,58,100,196,191,190,100,100,271,58,28,28,0,100,4,4,4,4,4,2,2,2,2,5,5,0,2023-12-21 05:08:00,0
5671,5673,5673,5673,2029,96,281,96,211,2029,70,96,202,199,197,96,96,281,70,28,28,0,96,4,4,4,4,4,4,2,2,2,3,3,0,2023-12-21 05:10:00,0
5700,5698,5698,5698,2027,104,291,104,214,2027,77,104,201,193,191,104,104,291,77,28,28,0,104,4,4,4,4,3,4,2,2,2,8,8,1,2023-12-21 05:12:00,0
5669,5671,5671,5671,2033,93,289,93,219,2033,70,93,199,192,191,93,93,289,70,31,31,0,93,7,7,7,7,7,2,2,2,2,7,7,0,2023-12-21 05:14:00,0
5674,5674,5674,5674,2038,88,284,88,221,2038,63,88,189,184,183,88,88,284,63,27,27,0,88,3,3,3,3,3,2,2,2,2,5,5,0,2023-12-21 05:16:00,0
5667,5666,5666,5666,2033,93,284,93,216,2033,68,93,190,188,187,93,93,284,68,28,28,0,93,4,4,4,4,3,2,2,2,2,2,2,1,2023-12-21 05:18:00,0
5610,5629,5610,5610,2021,92,266,92,212,2021,54,92,179,175,174,92,92,266,54,32,32,0,92,8,8,8,8,8,2,2,2,2,4,4,0,2023-12-21 05:20:00,0
5607,5606,5606,5606,2003,101,272,101,215,2003,57,101,191,190,189,101,101,272,57,27,27,0,101,3,3,3,3,3,2,2,2,2,1,1,0,2023-12-21 05:22:00,0
5652,5653,5653,5653,2033,87,273,87,211,2033,62,87,199,195,191,87,87,273,62,28,28,0,87,4,4,4,4,4,8,2,2,2,4,4,0,2023-12-21 05:24:00,0
5634,5635,5635,5635,2022,95,269,95,221,2022,48,95,193,190,190,95,95,269,48,28,28,0,95,4,4,4,4,4,0,2,2,2,3,3,0,2023-12-21 05:26:00,0
5659,5659,5659,5659,2037,97,298,97,232,2037,66,97,186,182,182,97,97,298,66,31,31,0,97,7,7,7,7,6,0,2,2,2,4,4,1,2023-12-21 05:28:00,0
5655,5693,5654,5654,2023,92,272,92,215,2023,57,92,206,202,202,92,92,272,57,28,28,0,92,4,4,4,4,4,0,2,2,2,4,4,0,2023-12-21 05:30:00,0
5699,5700,5700,5700,2044,101,286,101,206,2044,80,101,200,197,193,101,101,286,80,28,28,0,101,4,4,4,4,3,8,2,2,2,3,3,1,2023-12-21 05:32:00,0
5649,5649,5649,5649,2025,93,282,93,216,2025,66,93,182,179,178,93,93,282,66,27,27,0,93,3,3,3,3,3,2,2,2,2,3,3,0,2023-12-21 05:34:00,0
5623,5622,5622,5622,2020,81,278,81,221,2020,57,81,187,183,181,81,81,278,57,32,32,0,81,8,8,8,8,8,4,2,2,2,4,4,0,2023-12-21 05:36:00,0
5667,5666,5666,5666,2034,94,281,94,225,2034,56,94,196,193,189,94,94,281,56,27,27,0,94,3,3,3,3,3,8,2,2,2,3,3,0,2023-12-21 05:38:00,0
5644,5646,5646,5646,2018,100,281,100,201,2018,80,100,184,183,183,100,100,281,80,28,28,0,100,4,4,4,4,4,0,2,2,2,1,1,0,2023-12-21 05:40:00,0
5610,5610,5610,5610,2004,97,292,97,218,2004,74,97,186,184,183,97,97,292,74,32,32,0,97,7,7,7,7,7,2,2,2,2,2,2,0,2023-12-21 05:42:00,2
5646,5645,5645,5645,2029,83,278,82,212,2029,66,82,190,188,186,82,82,278,66,28,28,0,82,4,4,4,4,3,4,2,2,2,2,2,1,2023-12-21 05:44:00,0
5610,5611,5611,5611,2015,97,265,98,211,2015,54,98,191,190,188,98,98,265,54,28,28,0,98,4,4,4,4,4,4,2,2,2,1,1,0,2023-12-21 05:46:00,0
5634,5634,5634,5634,2016,100,277,100,216,2016,61,100,194,186,186,100,100,277,61,28,28,0,100,4,4,4,4,3,0,2,2,2,8,8,1,2023-12-21 05:48:00,0
5622,5620,5620,5620,2024,87,338,87,214,2024,124,87,184,179,178,87,87,338,73,32,32,0,87,8,8,7,7,7,2,2,2,2,5,5,0,2023-12-21 05:50:00,52
5662,5663,5663,5663,2030,99,287,99,214,2030,73,99,187,185,181,99,99,287,73,28,28,0,99,4,4,4,4,4,8,2,2,2,2,2,0,2023-12-21 05:52:00,0
5639,5640,5640,5640,2037,87,266,87,209,2037,57,87,191,188,186,87,87,266,57,27,27,0,87,3,3,3,3,3,4,2,2,2,3,3,0,2023-12-21 05:54:00,0
5609,5628,5608,5608,2024,87,265,87,212,2024,53,87,192,188,187,87,87,265,53,28,28,0,87,4,4,4,4,4,2,2,2,2,4,4,0,2023-12-21 05:56:00,0
5660,5662,5661,5661,2024,86,275,86,218,2024,57,86,199,192,189,86,86,275,57,31,31,0,86,7,7,7,7,7,6,2,2,2,7,7,0,2023-12-21 05:58:00,0
5643,5643,5643,5643,2027,94,273,94,210,2027,63,94,192,189,185,94,94,273,63,28,28,0,94,4,4,4,4,3,8,2,2,2,3,3,1,2023-12-21 06:00:00,0
5615,5614,5615,5615,1999,100,372,100,216,1999,156,100,191,191,191,100,100,372,156,28,28,0,100,4,4,4,4,4,0,2,2,2,0,0,0,2023-12-21 06:02:00,0
5640,5638,5638,5638,2022,104,385,104,209,2022,176,104,194,190,190,104,104,385,176,31,31,0,104,7,7,7,7,6,0,2,2,2,4,4,1,2023-12-21 06:04:00,0
5644,5646,5646,5646,2029,86,298,86,222,2029,76,86,187,184,184,86,86,298,76,28,28,0,86,4,4,4,4,4,0,2,2,2,3,3,0,2023-12-21 06:06:00,0
5634,5633,5633,5633,2039,91,258,91,203,2039,55,91,185,181,181,91,91,258,55,28,28,0,91,4,4,4,4,4,0,2,2,2,4,4,0,2023-12-21 06:08:00,0
5569,5589,5570,5570,1995,93,261,93,212,1995,49,93,192,190,187,93,93,261,49,27,27,0,93,3,3,3,3,3,6,2,2,2,2,2,0,2023-12-21 06:10:00,0
5652,5651,5651,5651,2016,97,298,97,217,2016,81,97,189,187,187,97,97,298,81,32,32,0,97,8,8,8,8,8,0,2,2,2,2,2,0,2023-12-21 06:12:00,0
5633,5634,5634,5634,2018,92,270,92,214,2018,56,92,201,195,193,92,92,270,56,27,27,0,92,3,3,3,3,3,4,2,2,2,6,6,0,2023-12-21 06:14:00,0
5647,5647,5647,5647,2022,92,282,92,217,2022,65,92,196,193,189,92,92,282,65,28,28,0,92,4,4,4,4,3,8,2,2,2,3,3,1,2023-12-21 06:16:00,0
5662,5662,5662,5662,2040,97,277,97,209,2040,68,97,181,179,179,97,97,277,68,31,31,0,97,7,7,7,7,7,0,2,2,2,2,2,0,2023-12-21 06:18:00,0
5688,5688,5688,5688,2030,95,287,95,217,2030,70,95,200,196,195,95,95,287,70,28,28,0,95,4,4,4,4,3,2,2,2,2,4,4,1,2023-12-21 06:20:00,0
5600,5600,5600,5600,2017,89,254,89,208,2017,46,89,194,190,189,89,89,254,46,28,28,0,89,4,4,4,4,4,2,2,2,2,4,4,0,2023-12-21 06:22:00,0
5612,5611,5611,5611,2025,87,250,87,203,2025,47,87,197,194,192,87,87,250,47,28,28,0,87,4,4,4,4,4,4,2,2,2,3,3,0,2023-12-21 06:24:00,0
5645,5646,5646,5646,2036,85,274,85,223,2036,51,85,188,186,183,85,85,274,51,31,31,0,85,7,7,7,7,7,6,2,2,2,2,2,0,2023-12-21 06:26:00,0
5660,5660,5660,5660,2032,99,265,99,211,2032,54,99,198,196,195,99,99,265,54,28,28,0,99,4,4,4,4,4,2,2,2,2,2,2,0,2023-12-21 06:28:00,0
5681,5681,5681,5681,2038,96,280,96,209,2038,71,96,201,195,190,96,96,280,71,27,27,0,96,3,3,3,3,3,10,2,2,2,6,6,0,2023-12-21 06:30:00,0
5623,5641,5621,5621,2032,88,277,88,216,2032,61,88,188,183,181,88,88,277,61,28,28,0,88,4,4,4,4,3,4,2,2,2,5,5,1,2023-12-21 06:32:00,0
5563,5565,5565,5565,2004,88,259,88,212,2004,47,88,188,184,184,88,88,259,47,30,30,0,88,7,7,7,7,7,0,2,2,2,4,4,0,2023-12-21 06:34:00,0
5659,5679,5659,5659,2025,90,307,90,227,2025,80,90,186,184,182,90,90,307,80,28,28,0,90,4,4,4,4,3,4,2,2,2,2,2,1,2023-12-21 06:36:00,0
5653,5653,5653,5653,2028,89,276,89,212,2028,64,89,187,182,182,89,89,276,64,28,28,0,89,4,4,4,4,4,0,2,2,2,5,5,0,2023-12-21 06:38:00,0
5667,5667,5667,5667,2039,93,286,93,208,2039,78,93,191,188,184,93,93,286,78,28,28,0,93,4,4,4,4,4,8,2,2,2,3,3,0,2023-12-21 06:40:00,0
5638,5638,5638,5638,2019,96,286,96,227,2019,59,96,200,197,194,96,96,286,59,31,31,0,96,7,7,7,7,7,6,2,2,2,3,3,0,2023-12-21 06:42:00,0
5662,5661,5661,5661,2031,93,276,93,210,2031,66,93,194,191,188,93,93,276,66,28,28,0,93,4,4,4,4,4,6,2,2,2,3,3,0,2023-12-21 06:44:00,0
5629,5629,5629,5629,2034,91,275,91,210,2034,65,91,180,179,178,91,91,275,65,29,29,0,91,4,4,4,4,3,2,2,2,2,1,1,1,2023-12-21 06:46:00,0
5658,5660,5659,5659,2022,96,289,96,209,2022,80,96,196,193,190,96,96,289,80,31,31,0,96,7,7,7,7,7,6,2,2,2,3,3,0,2023-12-21 06:48:00,0
5670,5668,5668,5668,2039,96,333,96,217,2039,116,96,197,194,193,96,96,333,65,28,28,0,96,4,4,3,3,3,2,2,2,2,3,3,0,2023-12-21 06:50:00,52
5619,5619,5619,5619,2019,83,276,83,214,2019,62,83,193,191,189,83,83,276,62,28,28,0,83,4,4,4,4,3,4,2,2,2,2,2,1,2023-12-21 06:52:00,0
5644,5645,5645,5645,2027,90,286,90,211,2027,75,90,186,183,182,90,90,286,75,28,28,0,90,4,4,4,4,4,2,2,2,2,3,3,0,2023-12-21 06:54:00,0
5653,5652,5652,5652,2031,93,289,92,217,2031,72,92,187,187,186,92,92,289,72,31,31,0,92,7,7,7,7,7,2,2,2,2,0,0,0,2023-12-21 06:56:00,0
5593,5595,5595,5595,2005,87,276,88,212,2005,64,88,180,178,177,88,88,276,64,27,27,4,88,4,4,4,4,4,2,2,2,2,2,2,0,2023-12-21 06:58:00,0
5635,5635,5635,5635,2027,98,272,98,214,2027,58,98,182,180,176,98,98,272,58,28,28,0,98,4,4,4,4,4,8,2,2,2,2,2,0,2023-12-21 07:00:00,0
5655,5655,5655,5655,2020,88,487,88,222,2020,265,88,186,183,181,88,88,487,265,31,31,0,88,7,7,7,7,6,4,2,2,2,3,3,1,2023-12-21 07:02:00,0
5626,5625,5625,5625,2025,94,269,94,204,2025,65,94,191,191,191,94,94,269,65,28,28,0,94,4,4,4,4,4,0,2,2,2,0,0,0,2023-12-21 07:04:00,0
5624,5625,5625,5625,2029,103,271,103,216,2029,55,103,188,182,179,103,103,271,55,27,27,0,103,3,3,3,3,3,6,2,2,2,6,6,0,2023-12-21 07:06:00,0
5696,5696,5696,5696,2037,105,300,105,217,2037,83,105,194,191,190,105,105,300,83,28,28,0,105,4,4,4,4,3,2,2,2,2,3,3,1,2023-12-21 07:08:00,0
5652,5651,5651,5651,2036,92,284,92,229,2036,55,92,182,180,178,92,92,284,55,32,32,0,92,8,8,8,8,8,4,2,2,2,2,2,0,2023-12-21 07:10:00,0
5612,5612,5612,5612,2015,93,272,93,211,2015,61,93,196,194,192,93,93,272,61,27,27,0,93,3,3,3,3,3,4,2,2,2,2,2,0,2023-12-21 07:12:00,0
5646,5646,5646,5646,2021,99,285,99,216,2021,69,99,196,191,188,99,99,285,69,28,28,0,99,4,4,4,4,4,6,2,2,2,5,5,0,2023-12-21 07:14:00,0
5647,5648,5648,5648,2025,90,277,90,215,2025,62,90,194,190,189,90,90,277,62,31,31,0,90,7,7,7,7,7,2,2,2,2,4,4,0,2023-12-21 07:16:00,0
5672,5672,5672,5672,2032,92,295,92,220,2032,75,92,189,187,183,92,92,295,75,28,28,0,92,4,4,4,4,3,8,2,2,2,2,2,1,2023-12-21 07:18:00,0
5606,5605,5605,5605,2016,95,270,95,206,2016,64,95,191,185,183,95,95,270,64,28,28,0,95,4,4,4,4,4,4,2,2,2,6,6,0,2023-12-21 07:20:00,0
5606,5607,5607,5607,2012,96,277,96,229,2012,48,96,194,191,190,96,96,277,48,28,28,0,96,4,4,4,4,3,2,2,2,2,3,3,1,2023-12-21 07:22:00,0
5638,5638,5638,5638,2034,82,261,82,208,2034,53,82,193,191,189,82,82,261,53,31,31,0,82,7,7,7,7,7,4,2,2,2,2,2,0,2023-12-21 07:24:00,0
5630,5648,5628,5628,2026,96,266,96,220,2026,46,96,189,185,184,96,96,266,46,28,28,0,96,4,4,4,4,4,2,2,2,2,4,4,0,2023-12-21 07:26:00,0
5657,5656,5656,5656,2032,95,286,95,220,2032,66,95,184,183,182,95,95,286,66,27,27,0,95,3,3,3,3,3,2,2,2,2,1,1,0,2023-12-21 07:28:00,0
5667,5668,5668,5668,2044,96,271,96,206,2044,65,96,194,192,191,96,96,271,65,28,28,0,96,4,4,4,4,4,2,2,2,2,2,2,0,2023-12-21 07:30:00,0
6940,6943,6943,6943,2487,98,381,98,280,2487,101,98,232,230,225,98,98,381,101,36,36,0,98,7,7,7,7,7,10,3,3,3,2,2,0,2023-12-21 07:32:00,0
5650,5649,5649,5649,2024,105,264,105,214,2024,50,105,192,191,190,105,105,264,50,28,28,0,105,4,4,4,4,3,2,2,2,2,1,1,1,2023-12-21 07:34:00,0
5619,5618,5618,5618,2023,92,276,92,210,2023,66,92,185,185,184,92,92,276,66,28,28,0,92,4,4,4,4,4,2,2,2,2,0,0,0,2023-12-21 07:36:00,0
5556,5556,5556,5556,1996,83,275,82,208,1996,67,82,189,186,180,82,82,275,67,31,31,0,82,7,7,7,7,6,12,2,2,2,3,3,1,2023-12-21 07:38:00,0
5661,5662,5662,5662,2029,103,281,104,211,2029,70,104,207,205,203,104,104,281,70,28,28,0,104,4,4,4,4,4,4,2,2,2,2,2,0,2023-12-21 07:40:00,0
5618,5619,5619,5619,2008,92,296,92,216,2008,80,92,193,189,185,92,92,296,80,28,28,0,92,4,4,4,4,4,8,2,2,2,4,4,0,2023-12-21 07:42:00,0
5658,5657,5657,5657,2024,92,283,92,219,2024,64,92,187,185,183,92,92,283,64,27,27,0,92,3,3,3,3,3,4,2,2,2,2,2,0,2023-12-21 07:44:00,0
5629,5630,5630,5630,2026,85,289,85,211,2026,78,85,197,190,188,85,85,289,78,32,32,0,85,8,8,8,8,8,4,2,2,2,7,7,0,2023-12-21 07:46:00,0
5660,5660,5660,5660,2032,95,268,95,210,2032,58,95,187,184,184,95,95,268,58,27,27,0,95,3,3,3,3,3,0,2,2,2,3,3,0,2023-12-21 07:48:00,0
5679,5676,5677,5677,2035,85,343,85,211,2035,132,85,193,190,188,85,85,343,81,29,29,0,85,5,5,4,4,3,4,2,2,2,3,3,1,2023-12-21 07:50:00,52
5619,5622,5621,5621,2021,90,269,90,211,2021,58,90,200,194,193,90,90,269,58,28,28,0,90,4,4,4,4,4,2,2,2,2,6,6,0,2023-12-21 07:52:00,0
5625,5625,5625,5625,2028,97,275,97,219,2028,56,97,194,192,191,97,97,275,56,31,31,0,97,7,7,7,7,6,2,2,2,2,2,2,1,2023-12-21 07:54:00,0
5677,5677,5677,5677,2031,95,286,95,213,2031,73,95,207,203,201,95,95,286,73,28,28,0,95,4,4,4,4,4,4,2,2,2,4,4,0,2023-12-21 07:56:00,0
5667,5667,5667,5667,2023,101,271,101,208,2023,63,101,196,193,191,101,101,271,63,28,28,0,101,4,4,4,4,4,4,2,2,2,3,3,0,2023-12-21 07:58:00,0
5645,5645,5645,5645,2025,96,271,91,218,2026,53,91,203,200,197,91,90,271,53,31,31,0,90,7,7,7,7,7,6,2,2,2,3,3,0,2023-12-21 08:00:00,2
5634,5632,5632,5632,1990,106,294,106,212,1990,82,106,195,190,188,106,106,294,82,28,28,0,106,4,4,4,4,4,4,2,2,2,5,5,0,2023-12-21 08:02:00,0
5654,5654,5654,5654,2021,98,302,98,223,2021,79,98,197,194,193,98,98,302,79,27,27,0,98,3,3,3,3,3,2,2,2,2,3,3,0,2023-12-21 08:04:00,0
5635,5637,5637,5637,2022,84,274,84,213,2022,61,84,192,184,181,84,84,274,61,28,28,0,84,4,4,4,4,3,6,2,2,2,8,8,1,2023-12-21 08:06:00,0
5624,5623,5623,5623,2026,94,284,94,216,2026,68,94,185,183,183,94,94,284,68,31,31,0,94,7,7,7,7,7,0,2,2,2,2,2,0,2023-12-21 08:08:00,0
5658,5660,5659,5659,2027,92,294,92,214,2027,80,92,195,190,186,92,92,294,80,28,28,0,92,4,4,4,4,3,8,2,2,2,5,5,1,2023-12-21 08:10:00,0
5636,5636,5636,5636,2018,97,284,97,216,2018,68,97,193,191,191,97,97,284,68,28,28,0,97,4,4,4,4,4,0,2,2,2,2,2,0,2023-12-21 08:12:00,0
5646,5645,5645,5645,2025,87,277,87,215,2025,62,87,193,188,187,87,87,277,62,31,31,0,87,7,7,7,7,7,2,2,2,2,5,5,0,2023-12-21 08:14:00,0
5653,5674,5654,5654,2027,88,291,88,213,2027,78,88,197,194,191,88,88,291,78,28,28,0,88,4,4,4,4,4,6,2,2,2,3,3,0,2023-12-21 08:16:00,0
5673,5672,5672,5672,2036,99,282,99,217,2036,65,99,191,186,184,99,99,282,65,28,28,0,99,4,4,4,4,4,4,2,2,2,5,5,0,2023-12-21 08:18:00,0
5672,5673,5673,5673,2031,95,299,95,223,2031,76,95,188,186,186,95,95,299,76,28,28,0,95,4,4,4,4,3,0,2,2,2,2,2,1,2023-12-21 08:20:00,0
5638,5638,5638,5638,2021,84,296,84,225,2021,71,84,193,188,186,84,84,296,71,31,31,0,84,7,7,7,7,7,4,2,2,2,5,5,0,2023-12-21 08:22:00,0
5652,5652,5652,5652,2032,93,271,93,213,2032,58,93,183,179,178,93,93,271,58,28,28,0,93,3,3,3,3,3,2,2,2,2,4,4,0,2023-12-21 08:24:00,2
5595,5614,5594,5594,2017,96,264,96,212,2017,52,96,186,185,184,96,96,264,52,28,28,0,96,4,4,4,4,3,2,2,2,2,1,1,1,2023-12-21 08:26:00,0
5702,5702,5702,5702,2042,102,292,102,219,2042,73,102,182,179,179,102,102,292,73,28,28,0,102,4,4,4,4,4,0,2,2,2,3,3,0,2023-12-21 08:28:00,0
5638,5638,5638,5638,2034,81,281,81,219,2034,62,81,199,194,194,81,81,281,62,31,31,0,81,7,7,7,7,7,0,2,2,2,5,5,0,2023-12-21 08:30:00,0
5655,5655,5655,5655,2024,91,272,91,212,2024,60,91,198,195,193,91,91,272,60,28,28,0,91,4,4,4,4,4,4,2,2,2,3,3,0,2023-12-21 08:32:00,0
5629,5629,5629,5629,2014,84,287,84,213,2014,74,84,184,183,181,84,84,287,74,29,29,0,84,4,4,4,4,4,4,2,2,2,1,1,0,2023-12-21 08:34:00,2
5582,5583,5583,5583,2002,92,270,92,211,2002,59,92,184,184,183,92,92,270,59,28,28,0,92,4,4,4,4,3,2,2,2,2,0,0,1,2023-12-21 08:36:00,0
5643,5641,5641,5641,2006,101,296,101,219,2006,77,101,188,187,186,101,101,296,77,31,31,0,101,7,7,7,7,7,2,2,2,2,1,1,0,2023-12-21 08:38:00,0
5645,5647,5647,5647,2016,91,279,91,218,2016,61,91,194,190,190,91,91,279,61,27,27,0,91,3,3,3,3,3,0,2,2,2,4,4,0,2023-12-21 08:40:00,0
5624,5624,5623,5623,2007,98,269,98,205,2007,64,98,199,198,193,98,98,269,64,28,28,0,98,4,4,4,4,3,10,2,2,2,1,1,1,2023-12-21 08:42:00,0
5615,5635,5616,5616,2018,87,272,87,215,2018,57,87,193,191,190,87,87,272,57,32,32,0,87,8,8,8,8,8,2,2,2,2,2,2,0,2023-12-21 08:44:00,0
5647,5646,5646,5646,2032,89,274,89,211,2032,63,89,186,186,186,89,89,274,63,27,27,0,89,3,3,3,3,3,0,2,2,2,0,0,0,2023-12-21 08:46:00,0
5679,5680,5680,5680,2033,87,277,87,218,2033,59,87,198,192,190,87,87,277,59,28,28,0,87,4,4,4,4,4,4,2,2,2,6,6,0,2023-12-21 08:48:00,0
5622,5621,5621,5621,2006,97,344,97,215,2006,129,97,194,188,186,97,97,344,78,29,29,0,97,5,5,4,4,4,4,2,2,2,6,6,0,2023-12-21 08:50:00,52
5621,5622,5622,5622,2025,93,267,93,210,2025,57,93,190,185,183,93,93,267,57,31,31,0,93,7,7,7,7,6,4,2,2,2,5,5,1,2023-12-21 08:52:00,0
5654,5654,5654,5654,2026,87,290,87,212,2026,78,87,195,191,190,87,87,290,78,28,28,0,87,4,4,4,4,4,2,2,2,2,4,4,0,2023-12-21 08:54:00,0
5643,5643,5643,5643,2026,89,275,89,206,2026,69,89,191,191,188,89,89,275,69,28,28,0,89,4,4,4,4,3,6,2,2,2,0,0,1,2023-12-21 08:56:00,0
5640,5640,5640,5640,2019,101,279,101,214,2019,65,101,186,185,183,101,101,279,65,27,27,0,101,3,3,3,3,3,4,2,2,2,1,1,0,2023-12-21 08:58:00,0
5644,5643,5643,5643,2031,90,272,90,217,2031,55,90,187,183,181,90,90,272,55,32,32,0,90,8,8,8,8,8,4,2,2,2,4,4,0,2023-12-21 09:00:00,0
5603,5622,5603,5603,2008,94,366,94,211,2008,155,94,199,190,187,94,94,366,155,27,27,0,94,3,3,3,3,3,6,2,2,2,9,9,0,2023-12-21 09:02:00,0
5637,5638,5638,5638,2039,85,265,85,216,2039,49,85,189,185,184,85,85,265,49,28,28,0,85,4,4,4,4,4,2,2,2,2,4,4,0,2023-12-21 09:04:00,0
5687,5685,5685,5685,2028,93,297,93,219,2028,78,93,193,189,189,93,93,297,78,31,31,0,93,7,7,7,7,7,0,2,2,2,4,4,0,2023-12-21 09:06:00,0
5626,5628,5628,5628,2029,92,286,92,220,2029,66,92,185,182,178,92,92,286,66,28,28,0,92,4,4,4,4,3,8,2,2,2,3,3,1,2023-12-21 09:08:00,0
5644,5643,5643,5643,2026,94,286,94,216,2026,70,94,188,184,183,94,94,286,70,28,28,0,94,4,4,4,4,4,2,2,2,2,4,4,0,2023-12-21 09:10:00,0
5658,5659,5659,5659,2036,86,277,86,215,2036,62,86,191,190,188,86,86,277,62,28,28,0,86,4,4,4,4,3,4,2,2,2,1,1,1,2023-12-21 09:12:00,0
5606,5606,5606,5606,2009,91,296,91,217,2009,79,91,196,191,191,91,91,296,79,31,31,0,91,7,7,7,7,7,0,2,2,2,5,5,0,2023-12-21 09:14:00,0
5659,5657,5657,5657,2033,100,249,100,192,2033,57,100,191,188,188,100,100,249,57,28,28,0,100,4,4,4,4,4,0,2,2,2,3,3,0,2023-12-21 09:16:00,0
5659,5660,5660,5660,2023,105,273,105,213,2023,60,105,191,183,182,105,105,273,60,27,27,0,105,3,3,3,3,3,2,2,2,2,8,8,0,2023-12-21 09:18:00,0
5639,5640,5640,5640,2022,87,262,87,210,2022,52,87,199,194,192,87,87,262,52,32,32,0,87,8,8,8,8,8,4,2,2,2,5,5,0,2023-12-21 09:20:00,0
5627,5627,5627,5627,2017,94,263,94,207,2017,56,94,186,184,182,94,94,263,56,27,27,0,94,3,3,3,3,3,4,2,2,2,2,2,0,2023-12-21 09:22:00,0
5632,5631,5631,5631,2028,95,276,95,217,2028,59,95,180,174,174,95,95,276,59,28,28,0,95,4,4,4,4,3,0,2,2,2,6,6,1,2023-12-21 09:24:00,0
5630,5631,5631,5631,2035,95,255,95,205,2035,50,95,188,186,185,95,95,255,50,28,28,0,95,4,4,4,4,4,2,2,2,2,2,2,0,2023-12-21 09:26:00,0
5620,5620,5620,5620,2027,89,262,89,201,2027,61,89,201,196,194,89,89,262,61,31,31,0,89,7,7,7,7,6,4,2,2,2,5,5,1,2023-12-21 09:28:00,0
5591,5591,5591,5591,2018,91,256,91,204,2018,52,91,189,188,187,91,91,256,52,28,28,0,91,4,4,4,4,4,2,2,2,2,1,1,0,2023-12-21 09:30:00,0
5643,5640,5640,5640,2026,91,280,91,217,2026,63,91,190,184,183,91,91,280,63,28,28,0,91,4,4,4,4,4,2,2,2,2,6,6,0,2023-12-21 09:32:00,0
5635,5638,5638,5638,2020,106,275,106,205,2020,70,106,190,186,186,106,106,275,70,27,27,0,106,3,3,3,3,3,0,2,2,2,4,4,0,2023-12-21 09:34:00,0
5657,5657,5657,5657,2029,102,279,102,220,2029,59,102,186,185,184,102,102,279,59,32,32,0,102,8,8,8,8,8,2,2,2,2,1,1,0,2023-12-21 09:36:00,0
5601,5602,5601,5601,2005,91,267,91,204,2005,63,91,177,176,175,91,91,267,63,26,26,0,91,3,3,3,3,3,2,2,2,2,1,1,0,2023-12-21 09:38:00,0
5660,5659,5659,5659,2036,93,274,93,214,2036,60,93,182,179,178,93,93,274,60,28,28,0,93,4,4,4,4,3,2,2,2,2,3,3,1,2023-12-21 09:40:00,0
5590,5591,5591,5591,2012,90,276,90,212,2012,64,90,186,184,181,90,90,276,64,31,31,0,90,7,7,7,7,7,6,2,2,2,2,2,0,2023-12-21 09:42:00,0
5654,5653,5653,5653,2033,101,286,101,214,2033,72,101,186,186,185,101,101,286,72,28,28,0,101,4,4,4,4,3,2,2,2,2,0,0,1,2023-12-21 09:44:00,0
5639,5638,5638,5638,2023,91,286,91,213,2023,73,91,187,184,181,91,91,286,73,28,28,0,91,4,4,4,4,4,6,2,2,2,3,3,0,2023-12-21 09:46:00,0
5640,5640,5640,5640,2030,93,274,93,217,2030,57,93,195,191,190,93,93,274,57,28,28,0,93,4,4,4,4,4,2,2,2,2,4,4,0,2023-12-21 09:48:00,0
5611,5613,5613,5613,2020,78,337,78,217,2020,120,78,173,170,169,78,78,337,69,32,32,0,78,8,8,7,7,7,2,2,2,2,3,3,0,2023-12-21 09:50:00,52
5680,5678,5678,5678,2031,99,284,99,226,2031,58,99,189,185,182,99,99,284,58,28,28,0,99,4,4,4,4,4,6,2,2,2,4,4,0,2023-12-21 09:52:00,0
5648,5649,5649,5649,2035,86,271,86,211,2035,60,86,197,194,191,86,86,271,60,28,28,0,86,4,4,4,4,3,6,2,2,2,3,3,1,2023-12-21 09:54:00,0
5685,5686,5686,5686,2027,80,318,80,235,2027,83,80,206,204,200,80,80,318,83,31,31,0,80,7,7,7,7,7,8,2,2,2,2,2,0,2023-12-21 09:56:00,0
5657,5657,5657,5657,2034,91,282,91,209,2034,73,91,197,194,193,91,91,282,73,27,27,3,91,3,3,3,3,3,2,2,2,2,3,3,0,2023-12-21 09:58:00,0
5626,5626,5626,5626,2024,91,264,91,206,2024,58,91,189,185,181,91,91,264,58,28,28,0,91,4,4,4,4,3,8,2,2,2,4,4,1,2023-12-21 10:00:00,0
5581,5581,5581,5581,2001,84,481,84,212,2001,269,84,199,195,191,84,84,481,269,28,28,0,84,4,4,4,4,4,8,2,2,2,4,4,0,2023-12-21 10:02:00,0
5659,5659,5659,5659,2024,105,270,105,208,2024,62,105,182,180,177,105,105,270,62,31,31,0,105,7,7,7,7,7,6,2,2,2,2,2,0,2023-12-21 10:04:00,0
5641,5640,5640,5640,2024,94,278,94,220,2024,58,94,185,184,183,94,94,278,58,28,28,0,94,4,4,4,4,4,2,2,2,2,1,1,0,2023-12-21 10:06:00,0
5682,5681,5681,5681,2024,95,293,95,217,2024,76,95,192,191,188,95,95,293,76,28,28,0,95,4,4,4,4,4,6,2,2,2,1,1,0,2023-12-21 10:08:00,0
5658,5659,5659,5659,2028,89,275,89,206,2028,69,89,196,191,189,89,89,275,69,28,28,0,89,4,4,4,4,3,4,2,2,2,5,5,1,2023-12-21 10:10:00,0
5635,5636,5636,5636,2018,87,277,87,227,2018,50,87,190,189,186,87,87,277,50,31,31,0,87,7,7,7,7,7,6,2,2,2,1,1,0,2023-12-21 10:12:00,0
5652,5652,5652,5652,2033,93,411,93,360,2033,51,93,192,185,185,93,93,411,51,161,161,0,93,70,3,3,3,3,0,2,2,2,7,7,0,2023-12-21 10:14:00,201
5581,5580,5580,5580,2018,94,251,94,199,2018,52,94,181,179,179,94,94,251,52,28,28,0,94,4,4,4,4,3,0,2,2,2,2,2,1,2023-12-21 10:16:00,0
5662,5662,5662,5662,2022,98,282,93,218,2023,64,93,193,188,185,93,92,282,64,32,32,0,92,8,8,8,8,8,6,2,2,2,5,5,0,2023-12-21 10:18:00,2
5682,5683,5683,5683,2032,87,301,87,223,2032,78,87,198,197,195,87,87,301,78,27,27,0,87,3,3,3,3,3,4,2,2,2,1,1,0,2023-12-21 10:20:00,0
5660,5681,5659,5659,2009,97,296,97,214,2009,82,97,203,197,193,97,97,296,82,28,28,0,97,4,4,4,4,4,8,2,2,2,6,6,0,2023-12-21 10:22:00,0
5647,5648,5648,5648,2022,92,286,92,217,2022,69,92,195,194,192,92,92,286,69,28,28,7,92,4,4,4,4,4,4,2,2,2,1,1,0,2023-12-21 10:24:00,0
5571,5571,5571,5571,2003,95,265,95,211,2003,54,95,188,185,184,95,95,265,54,31,31,3,95,7,7,7,7,6,2,2,2,2,3,3,1,2023-12-21 10:26:00,0
5643,5643,5643,5643,2031,90,273,90,205,2031,68,90,202,196,193,90,90,273,68,28,28,3,90,4,4,4,4,4,6,2,2,2,6,6,0,2023-12-21 10:28:00,0
5621,5619,5619,5619,2014,83,285,83,220,2014,65,83,190,188,187,83,83,285,65,28,28,1,83,4,4,4,4,3,2,2,2,2,2,2,1,2023-12-21 10:30:00,0
5644,5645,5645,5645,2028,97,287,97,215,2028,72,97,191,190,188,97,97,287,72,31,31,0,97,7,7,7,7,7,4,2,2,2,1,1,0,2023-12-21 10:32:00,0
5644,5645,5645,5645,2032,85,283,85,219,2032,64,85,192,187,184,85,85,283,64,28,28,0,85,4,4,4,4,4,6,2,2,2,5,5,0,2023-12-21 10:34:00,0
5639,5638,5638,5638,2016,91,289,91,221,2016,68,91,181,179,179,91,91,289,68,27,27,3,91,3,3,3,3,3,0,2,2,2,2,2,0,2023-12-21 10:36:00,0
5685,5686,5686,5686,2035,89,278,89,210,2035,68,89,193,190,187,89,89,278,68,28,28,6,89,4,4,4,4,4,6,2,2,2,3,3,0,2023-12-21 10:38:00,0
5640,5639,5639,5639,2025,89,280,89,216,2025,64,89,202,198,197,89,89,280,64,31,31,4,89,7,7,7,7,7,2,2,2,2,4,4,0,2023-12-21 10:40:00,0
5624,5625,5625,5625,2018,96,283,96,211,2018,72,96,202,198,194,96,96,283,72,28,28,0,96,4,4,4,4,3,8,2,2,2,4,4,1,2023-12-21 10:42:00,0
5641,5638,5638,5638,2021,91,270,91,212,2021,58,91,189,185,183,91,91,270,58,28,28,0,91,4,4,4,4,4,4,2,2,2,4,4,0,2023-12-21 10:44:00,0
5642,5645,5645,5645,2025,90,299,90,217,2025,82,90,198,195,195,90,90,299,82,28,28,4,90,4,4,4,4,3,0,2,2,2,3,3,1,2023-12-21 10:46:00,0
5632,5632,5632,5632,2022,97,277,97,209,2022,68,97,187,182,180,97,97,277,68,31,31,2,97,7,7,7,7,7,4,2,2,2,5,5,0,2023-12-21 10:48:00,0
5621,5644,5621,5621,2013,92,342,92,215,2013,127,92,190,186,185,92,92,342,76,29,29,2,92,5,5,4,4,4,2,2,2,2,4,4,0,2023-12-21 10:50:00,52
5636,5637,5635,5635,2025,104,265,104,200,2025,65,104,199,197,194,104,104,265,65,27,27,0,104,3,3,3,3,3,6,2,2,2,2,2,0,2023-12-21 10:52:00,0
5702,5702,5702,5702,2039,100,307,100,219,2039,88,100,197,193,191,100,100,307,88,32,32,2,100,8,8,8,8,8,4,2,2,2,4,4,0,2023-12-21 10:54:00,0
5648,5672,5648,5648,2028,87,283,87,218,2028,65,87,195,192,191,87,87,283,65,27,27,5,87,3,3,3,3,3,2,2,2,2,3,3,0,2023-12-21 10:56:00,0
5668,5669,5669,5669,2035,88,284,88,220,2035,64,88,202,199,199,88,88,284,64,28,28,7,88,4,4,4,4,3,0,2,2,2,3,3,1,2023-12-21 10:58:00,0
5651,5651,5651,5651,2035,89,279,89,205,2035,74,89,189,186,184,89,89,279,74,28,28,3,89,4,4,4,4,4,4,2,2,2,3,3,0,2023-12-21 11:00:00,0
5617,5616,5616,5616,2007,99,281,99,218,2007,63,99,198,194,194,99,99,281,63,31,31,1,99,7,7,7,7,6,0,2,2,2,4,4,1,2023-12-21 11:02:00,0
5637,5638,5638,5638,2016,84,286,84,222,2016,64,84,186,184,180,84,84,286,64,28,28,4,84,4,4,4,4,4,8,2,2,2,2,2,0,2023-12-21 11:04:00,0
5619,5617,5617,5617,2021,86,272,86,218,2021,54,86,187,185,185,86,86,272,54,28,28,3,86,4,4,4,4,4,0,2,2,2,2,2,0,2023-12-21 11:06:00,0
5623,5629,5625,5625,2027,85,289,85,208,2027,81,85,184,183,183,85,85,289,81,27,27,1,85,3,3,3,3,3,0,2,2,2,1,1,0,2023-12-21 11:08:00,0
5680,5679,5679,5679,2037,96,283,96,218,2037,65,96,201,199,197,96,96,283,65,32,32,0,96,8,8,8,8,8,4,2,2,2,2,2,0,2023-12-21 11:10:00,0
5637,5637,5637,5637,2032,95,258,95,204,2032,54,95,188,186,183,95,95,258,54,27,27,4,95,3,3,3,3,3,6,2,2,2,2,2,0,2023-12-21 11:12:00,0
5635,5636,5636,5636,2021,92,275,92,212,2021,63,92,188,184,182,92,92,275,63,28,28,0,92,4,4,4,4,3,4,2,2,2,4,4,1,2023-12-21 11:14:00,0
5592,5592,5592,5592,2010,91,281,91,219,2010,62,91,200,199,198,91,91,281,62,31,31,7,91,7,7,7,7,7,2,2,2,2,1,1,0,2023-12-21 11:16:00,0
5650,5649,5649,5649,2036,97,278,96,210,2036,68,96,193,192,188,96,96,278,68,28,28,9,96,4,4,4,4,3,8,2,2,2,1,1,1,2023-12-21 11:18:00,0
5628,5628,5628,5628,2017,97,268,98,213,2017,55,98,195,188,188,98,98,268,55,28,28,4,98,4,4,4,4,4,0,2,2,2,7,7,0,2023-12-21 11:20:00,0
5583,5584,5584,5584,2018,88,305,88,261,2018,44,88,193,192,191,88,88,305,44,76,76,0,88,28,4,4,4,4,2,2,2,2,1,1,0,2023-12-21 11:22:00,72
5622,5622,5622,5622,2036,85,257,85,214,2036,43,85,201,198,197,85,85,257,43,31,31,0,85,7,7,7,7,7,2,2,2,2,3,3,0,2023-12-21 11:24:00,0
5629,5628,5628,5628,2035,108,254,108,207,2035,47,108,184,182,182,108,108,254,47,28,28,0,108,4,4,4,4,4,0,2,2,2,2,2,0,2023-12-21 11:26:00,0
5673,5673,5673,5673,2031,103,275,103,228,2031,47,103,196,193,190,103,103,275,47,28,28,0,103,4,4,4,4,3,6,2,2,2,3,3,1,2023-12-21 11:28:00,0
5620,5620,5620,5620,2032,104,244,104,206,2032,38,104,186,181,180,104,104,244,38,31,31,0,104,7,7,7,7,7,2,2,2,2,5,5,0,2023-12-21 11:30:00,0
5638,5638,5638,5638,2023,91,268,91,216,2023,52,91,196,193,191,91,91,268,52,27,27,0,91,3,3,3,3,3,4,2,2,2,3,3,0,2023-12-21 11:32:00,0
5637,5638,5638,5638,2035,91,280,91,217,2035,63,91,195,187,185,91,91,280,63,28,28,5,91,4,4,4,4,3,4,2,2,2,8,8,1,2023-12-21 11:34:00,0
5695,5695,5695,5695,2046,102,266,102,209,2046,57,102,203,200,199,102,102,266,57,28,28,1,102,4,4,4,4,4,2,2,2,2,3,3,0,2023-12-21 11:36:00,0
5583,5606,5583,5583,2008,93,274,93,212,2008,62,93,188,186,185,93,93,274,62,31,31,4,93,7,7,7,7,7,2,2,2,2,2,2,0,2023-12-21 11:38:00,0
5604,5603,5603,5603,2020,86,268,86,211,2020,57,86,191,187,184,86,86,268,57,28,28,0,86,4,4,4,4,4,6,2,2,2,4,4,0,2023-12-21 11:40:00,0
5630,5629,5629,5629,2008,87,281,87,209,2008,72,87,201,197,195,87,87,281,72,28,28,0,87,4,4,4,4,4,4,2,2,2,4,4,0,2023-12-21 11:42:00,0
5627,5629,5628,5628,2027,84,270,84,211,2027,59,84,189,187,186,84,84,270,59,28,28,0,84,4,4,4,4,3,2,2,2,2,2,2,1,2023-12-21 11:44:00,0
5661,5661,5661,5661,2040,97,283,97,214,2040,69,97,191,189,188,97,97,283,69,31,31,0,97,7,7,7,7,7,2,2,2,2,2,2,0,2023-12-21 11:46:00,0
5638,5638,5638,5638,2029,91,270,91,212,2029,58,91,195,193,192,91,91,270,58,27,27,0,91,3,3,3,3,3,2,2,2,2,2,2,0,2023-12-21 11:48:00,0
5638,5637,5637,5637,2027,93,318,93,211,2027,107,93,189,183,181,93,93,318,56,29,29,0,93,5,5,4,4,3,4,2,2,2,6,6,1,2023-12-21 11:50:00,52
5599,5601,5601,5601,2024,91,270,91,219,2024,51,91,180,178,177,91,91,270,51,32,32,0,91,8,8,8,8,8,2,2,2,2,2,2,0,2023-12-21 11:52:00,0
5620,5620,5620,5620,2020,93,267,93,207,2020,60,93,187,185,184,93,93,267,60,27,27,0,93,3,3,3,3,3,2,2,2,2,2,2,0,2023-12-21 11:54:00,0
5629,5628,5628,5628,2024,88,286,88,216,2024,70,88,182,180,179,88,88,286,70,28,28,0,88,4,4,4,4,4,2,2,2,2,2,2,0,2023-12-21 11:56:00,0
5663,5663,5663,5663,2027,96,289,96,216,2027,73,96,193,189,184,96,96,289,73,28,28,0,96,4,4,4,4,4,10,2,2,2,4,4,0,2023-12-21 11:58:00,0
5586,5586,5586,5586,2016,95,260,95,206,2016,54,95,188,182,181,95,95,260,54,31,31,4,95,7,7,7,7,6,2,2,2,2,6,6,1,2023-12-21 12:00:00,0
5533,5533,5533,5533,1981,86,355,86,202,1981,153,86,187,182,181,86,86,355,153,27,27,1,86,4,4,4,4,4,2,2,2,2,5,5,0,2023-12-21 12:02:00,0
5608,5609,5609,5609,2013,101,256,101,206,2013,50,101,190,188,188,101,101,256,50,28,28,0,101,4,4,4,4,3,0,2,2,2,2,2,1,2023-12-21 12:04:00,0
5652,5652,5651,5651,2020,91,279,90,207,2020,72,90,196,190,187,90,90,279,72,31,31,3,90,7,7,7,7,7,6,2,2,2,6,6,0,2023-12-21 12:06:00,0
5611,5612,5612,5612,2023,91,273,92,208,2023,65,92,201,196,194,92,92,273,65,28,28,1,92,4,4,4,4,4,4,2,2,2,5,5,0,2023-12-21 12:08:00,0
5696,5696,5696,5696,2033,106,278,106,215,2033,63,106,194,193,190,106,106,278,63,27,27,0,106,3,3,3,3,3,6,2,2,2,1,1,0,2023-12-21 12:10:00,0
5659,5659,5659,5659,2033,96,286,96,215,2033,71,96,192,189,188,96,96,286,71,28,28,4,96,4,4,4,4,4,2,2,2,2,3,3,0,2023-12-21 12:12:00,0
5646,5645,5645,5645,2023,97,276,97,218,2023,58,97,197,196,194,97,97,276,58,32,32,0,97,7,7,7,7,7,4,2,2,2,1,1,0,2023-12-21 12:14:00,0
5675,5674,5674,5674,2035,86,296,86,233,2035,63,86,190,185,184,86,86,296,63,28,28,0,86,4,4,4,4,3,2,2,2,2,5,5,1,2023-12-21 12:16:00,0
5661,5663,5663,5663,2038,101,278,101,219,2038,59,101,188,187,186,101,101,278,59,28,28,0,101,4,4,4,4,4,2,2,2,2,1,1,0,2023-12-21 12:18:00,0
5621,5621,5621,5621,2031,87,257,87,203,2031,54,87,189,187,186,87,87,257,54,28,28,0,87,4,4,4,4,3,2,2,2,2,2,2,1,2023-12-21 12:20:00,0
5626,5626,5626,5626,2013,88,287,88,225,2013,62,88,186,183,182,88,88,287,62,31,31,0,88,7,7,7,7,7,2,2,2,2,3,3,0,2023-12-21 12:22:00,0
5645,5642,5642,5642,2019,98,290,98,215,2019,75,98,191,187,184,98,98,290,75,28,28,0,98,4,4,4,4,4,6,2,2,2,4,4,0,2023-12-21 12:24:00,0
5588,5588,5588,5588,2006,99,256,99,203,2006,53,99,187,184,182,99,99,256,53,26,26,0,99,3,3,3,3,3,4,2,2,2,3,3,0,2023-12-21 12:26:00,0
5622,5623,5623,5623,2034,89,259,89,218,2034,41,89,182,179,179,89,89,259,41,32,32,0,89,8,8,8,8,8,0,2,2,2,3,3,0,2023-12-21 12:28:00,0
5614,5615,5615,5615,2029,87,247,87,211,2029,36,87,183,179,178,87,87,247,36,27,27,0,87,3,3,3,3,3,2,2,2,2,4,4,0,2023-12-21 12:30:00,0
5625,5624,5624,5624,2017,81,271,81,205,2017,66,81,202,201,197,81,81,271,66,28,28,0,81,4,4,4,4,3,8,2,2,2,1,1,1,2023-12-21 12:32:00,0
5669,5669,5669,5669,2028,106,285,105,213,2028,72,105,187,181,179,105,105,285,72,28,28,0,105,4,4,4,4,4,4,2,2,2,6,6,0,2023-12-21 12:34:00,0
5662,5664,5664,5664,2037,84,289,85,221,2037,68,85,192,188,187,85,85,289,68,31,31,0,85,7,7,7,7,6,2,2,2,2,4,4,1,2023-12-21 12:36:00,0
5642,5642,5642,5642,2033,81,262,81,211,2033,51,81,198,196,194,81,81,262,51,28,28,0,81,4,4,4,4,4,4,2,2,2,2,2,0,2023-12-21 12:38:00,0
5606,5605,5605,5605,2020,96,258,96,207,2020,51,96,190,188,188,96,96,258,51,28,28,0,96,4,4,4,4,4,0,2,2,2,2,2,0,2023-12-21 12:40:00,0
5614,5615,5615,5615,2013,87,286,87,208,2013,78,87,188,183,182,87,87,286,78,31,31,0,87,7,7,7,7,7,2,2,2,2,5,5,0,2023-12-21 12:42:00,0
5678,5677,5677,5677,2032,91,296,90,222,2032,74,90,198,195,192,90,90,296,74,28,28,0,90,4,4,4,4,4,6,2,2,2,3,3,0,2023-12-21 12:44:00,0
5626,5626,5626,5626,2027,85,266,86,214,2027,52,86,194,190,187,86,86,266,52,27,27,0,86,3,3,3,3,3,6,2,2,2,4,4,0,2023-12-21 12:46:00,0
5681,5682,5682,5682,2031,93,279,93,212,2031,67,93,207,200,199,93,93,279,67,28,28,0,93,4,4,4,4,3,2,2,2,2,7,7,1,2023-12-21 12:48:00,0
5593,5593,5593,5593,2019,91,326,91,217,2019,109,91,184,181,180,91,91,326,58,32,32,0,91,8,8,7,7,7,2,2,2,2,3,3,0,2023-12-21 12:50:00,52
5658,5658,5658,5658,2028,98,281,98,213,2028,68,98,182,180,178,98,98,281,68,28,28,4,98,4,4,4,4,3,4,2,2,2,2,2,1,2023-12-21 12:52:00,0
5655,5654,5654,5654,2029,91,283,91,214,2029,69,91,190,189,189,91,91,283,69,28,28,0,91,4,4,4,4,4,0,2,2,2,1,1,0,2023-12-21 12:54:00,0
5641,5642,5642,5642,2029,90,272,90,217,2029,55,90,192,191,188,90,90,272,55,28,28,0,90,4,4,4,4,4,6,2,2,2,1,1,0,2023-12-21 12:56:00,0
5644,5643,5643,5643,2024,98,287,98,222,2024,65,98,195,192,191,98,98,287,65,31,31,0,98,7,7,7,7,7,2,2,2,2,3,3,0,2023-12-21 12:58:00,0
5664,5665,5665,5665,2036,88,268,88,218,2036,50,88,185,180,179,88,88,268,50,28,28,0,88,4,4,4,4,4,2,2,2,2,5,5,0,2023-12-21 13:00:00,0
5659,5678,5656,5656,2021,109,376,109,219,2021,157,109,188,184,180,109,109,376,157,28,28,0,109,4,4,4,4,3,8,2,2,2,4,4,1,2023-12-21 13:02:00,0
5636,5638,5638,5638,2030,88,268,88,217,2030,51,88,201,194,191,88,88,268,51,31,31,0,88,7,7,7,7,7,6,2,2,2,7,7,0,2023-12-21 13:04:00,0
5636,5637,5637,5637,2026,98,266,98,199,2026,67,98,185,181,180,98,98,266,67,27,27,0,98,3,3,3,3,3,2,2,2,2,4,4,0,2023-12-21 13:06:00,0
5677,5677,5677,5677,2039,82,282,82,227,2039,55,82,186,185,182,82,82,282,55,28,28,4,82,4,4,4,4,3,6,2,2,2,1,1,1,2023-12-21 13:08:00,0
5635,5633,5633,5633,2029,98,263,98,206,2029,57,98,189,188,186,98,98,263,57,28,28,0,98,4,4,4,4,4,4,2,2,2,1,1,0,2023-12-21 13:10:00,0
5635,5636,5636,5636,2016,93,286,93,222,2016,64,93,198,195,194,93,93,286,64,31,31,0,93,7,7,7,7,7,2,2,2,2,3,3,0,2023-12-21 13:12:00,0
5576,5576,5576,5576,2008,85,279,85,214,2008,65,85,187,185,183,85,85,279,65,28,28,0,85,4,4,4,4,4,4,2,2,2,2,2,0,2023-12-21 13:14:00,0
5663,5662,5662,5662,2029,101,302,101,232,2029,70,101,189,187,185,101,101,302,70,28,28,0,101,4,4,4,4,4,4,2,2,2,2,2,0,2023-12-21 13:16:00,0
5646,5648,5648,5648,2023,83,288,83,220,2023,68,83,185,184,184,83,83,288,68,31,31,0,83,7,7,7,7,6,0,2,2,2,1,1,1,2023-12-21 13:18:00,0
5696,5694,5694,5694,2033,99,282,99,222,2033,60,99,201,197,196,99,99,282,60,28,28,0,99,4,4,4,4,4,2,2,2,2,4,4,0,2023-12-21 13:20:00,0
5614,5615,5615,5615,2013,93,269,93,220,2013,49,93,192,190,190,93,93,269,49,27,27,0,93,3,3,3,3,3,0,2,2,2,2,2,0,2023-12-21 13:22:00,0
5644,5644,5644,5644,2033,96,265,96,212,2033,53,96,184,183,183,96,96,265,53,28,28,0,96,4,4,4,4,3,0,2,2,2,1,1,1,2023-12-21 13:24:00,0
5620,5621,5621,5621,2024,96,261,96,212,2024,49,96,189,187,184,96,96,261,49,32,32,0,96,8,8,8,8,8,6,2,2,2,2,2,0,2023-12-21 13:26:00,0
5640,5640,5640,5640,2025,96,273,96,210,2025,63,96,185,182,181,96,96,273,63,27,27,0,96,3,3,3,3,3,2,2,2,2,3,3,0,2023-12-21 13:28:00,0
5672,5695,5672,5672,2038,85,279,85,217,2038,62,85,201,200,199,85,85,279,62,28,28,0,85,4,4,4,4,4,2,2,2,2,1,1,0,2023-12-21 13:30:00,0
5650,5648,5648,5648,2029,91,269,91,212,2029,57,91,188,183,182,91,91,269,57,28,28,0,91,4,4,4,4,4,2,2,2,2,5,5,0,2023-12-21 13:32:00,0
5605,5606,5606,5606,2018,89,286,89,223,2018,63,89,185,181,180,89,89,286,63,31,31,0,89,7,7,7,7,6,2,2,2,2,4,4,1,2023-12-21 13:34:00,0
5659,5660,5660,5660,2033,99,267,99,213,2033,54,99,195,193,190,99,99,267,54,28,28,0,99,4,4,4,4,4,6,2,2,2,2,2,0,2023-12-21 13:36:00,0
5602,5602,5602,5602,2007,91,276,91,215,2007,61,91,189,187,187,91,91,276,61,28,28,0,91,4,4,4,4,3,0,2,2,2,2,2,1,2023-12-21 13:38:00,0
5661,5661,5661,5661,2023,97,287,97,226,2023,61,97,196,194,192,97,97,287,61,31,31,0,97,7,7,7,7,7,4,2,2,2,2,2,0,2023-12-21 13:40:00,0
5653,5653,5653,5653,2022,97,272,97,205,2022,67,97,189,186,185,97,97,272,67,28,28,0,97,4,4,4,4,4,2,2,2,2,3,3,0,2023-12-21 13:42:00,0
5672,5672,5672,5672,2026,100,281,100,224,2026,57,100,193,191,187,100,100,281,57,27,27,0,100,3,3,3,3,3,8,2,2,2,2,2,0,2023-12-21 13:44:00,0
5651,5650,5650,5650,2018,96,293,96,214,2018,79,96,193,188,186,96,96,293,79,28,28,0,96,4,4,4,4,4,4,2,2,2,5,5,0,2023-12-21 13:46:00,0
5606,5605,5605,5605,2022,75,256,75,211,2022,45,75,187,182,182,75,75,256,45,31,31,0,75,7,7,7,7,7,0,2,2,2,5,5,0,2023-12-21 13:48:00,0
5618,5619,5619,5619,2016,99,327,98,219,2016,108,98,190,187,186,98,98,327,57,29,29,0,98,5,5,4,4,3,2,2,2,2,3,3,1,2023-12-21 13:50:00,52
5644,5646,5644,5644,2029,83,279,84,219,2029,60,84,199,195,192,84,84,279,60,28,28,0,84,4,4,4,4,4,6,2,2,2,4,4,0,2023-12-21 13:52:00,0
5632,5633,5633,5633,2026,85,270,85,213,2026,57,85,206,201,199,85,85,270,57,31,31,0,85,7,7,7,7,6,4,2,2,2,5,5,1,2023-12-21 13:54:00,0
5672,5674,5672,5672,2018,91,286,91,229,2018,57,91,196,191,190,91,91,286,57,28,28,0,91,4,4,4,4,4,2,2,2,2,5,5,0,2023-12-21 13:56:00,0
5649,5647,5647,5647,2035,90,273,90,216,2035,57,90,189,186,182,90,90,273,57,28,28,0,90,4,4,4,4,4,8,2,2,2,3,3,0,2023-12-21 13:58:00,0
5616,5616,5616,5616,2023,88,253,88,205,2023,48,88,197,194,194,88,88,253,48,27,27,0,88,3,3,3,3,3,0,2,2,2,3,3,0,2023-12-21 14:00:00,0
5640,5641,5641,5641,2020,93,370,93,214,2020,156,93,199,197,196,93,93,370,156,32,32,0,93,8,8,8,8,8,2,2,2,2,2,2,0,2023-12-21 14:02:00,0
5621,5624,5622,5622,2011,83,288,83,211,2011,77,83,196,191,189,83,83,288,77,27,27,0,83,3,3,3,3,3,4,2,2,2,5,5,0,2023-12-21 14:04:00,0
5631,5631,5631,5631,2023,105,266,105,212,2023,54,105,191,186,183,105,105,266,54,28,28,0,105,4,4,4,4,3,6,2,2,2,5,5,1,2023-12-21 14:06:00,0
5634,5634,5634,5634,2021,93,263,93,210,2021,53,93,205,200,199,93,93,263,53,28,28,0,93,4,4,4,4,4,2,2,2,2,5,5,0,2023-12-21 14:08:00,0
5616,5616,5616,5616,2026,82,278,82,209,2026,69,82,196,194,194,82,82,278,69,31,31,0,82,7,7,7,7,6,0,2,2,2,2,2,1,2023-12-21 14:10:00,0
5659,5658,5658,5658,2025,86,291,86,221,2025,70,86,194,192,192,86,86,291,70,28,28,0,86,4,4,4,4,4,0,2,2,2,2,2,0,2023-12-21 14:12:00,0
5638,5637,5637,5637,2021,88,288,88,218,2021,70,88,190,186,186,88,88,288,70,28,28,0,88,4,4,4,4,4,0,2,2,2,4,4,0,2023-12-21 14:14:00,0
5619,5620,5620,5620,2019,93,264,93,213,2019,51,93,191,185,183,93,93,264,51,31,31,0,93,7,7,7,7,7,4,2,2,2,6,6,0,2023-12-21 14:16:00,0
5643,5643,5643,5643,2026,93,274,93,216,2026,58,93,196,191,191,93,93,274,58,28,28,5,93,4,4,4,4,4,0,2,2,2,5,5,0,2023-12-21 14:18:00,0
5664,5664,5664,5664,2038,96,257,96,207,2038,50,96,189,185,182,96,96,257,50,27,27,0,96,3,3,3,3,3,6,2,2,2,4,4,0,2023-12-21 14:20:00,0
5620,5621,5621,5621,2016,77,290,77,216,2016,74,77,187,183,180,77,77,290,74,28,28,0,77,4,4,4,4,3,6,2,2,2,4,4,1,2023-12-21 14:22:00,0
5638,5637,5637,5637,2013,95,302,95,223,2013,79,95,191,191,189,95,95,302,79,31,31,0,95,7,7,7,7,7,4,2,2,2,0,0,0,2023-12-21 14:24:00,0
5620,5620,5620,5620,2020,101,258,101,212,2020,46,101,187,185,184,101,101,258,46,28,28,0,101,4,4,4,4,3,2,2,2,2,2,2,1,2023-12-21 14:26:00,0
5637,5637,5637,5637,2018,89,271,89,209,2018,62,89,185,183,180,89,89,271,62,28,28,0,89,4,4,4,4,4,6,2,2,2,2,2,0,2023-12-21 14:28:00,0
5618,5615,5615,5615,2024,89,279,89,229,2024,50,89,182,181,180,89,89,279,50,31,31,0,89,7,7,7,7,7,2,2,2,2,1,1,0,2023-12-21 14:30:00,0
5618,5618,5618,5618,2007,94,287,94,233,2007,54,94,188,187,186,94,94,287,54,34,34,0,94,7,4,4,4,4,2,2,2,2,1,1,0,2023-12-21 14:32:00,9
5664,5668,5668,5668,2005,95,309,95,217,2005,92,95,200,198,196,95,95,309,92,28,28,0,95,4,4,4,4,4,4,2,2,2,2,2,0,2023-12-21 14:34:00,0
5648,5647,5647,5647,2030,99,290,99,213,2030,77,99,191,185,183,99,99,290,77,34,34,0,99,4,4,4,4,3,4,2,2,2,6,6,1,2023-12-21 14:36:00,12
5620,5619,5619,5619,2015,77,301,77,214,2015,87,77,196,189,187,77,77,301,87,31,31,5,77,7,7,7,7,7,4,2,2,2,7,7,0,2023-12-21 14:38:00,0
5621,5623,5623,5623,2009,96,306,96,221,2009,85,96,186,184,184,96,96,306,85,29,29,3,96,4,3,3,3,3,0,2,2,2,2,2,0,2023-12-21 14:40:00,3
5562,5561,5561,5561,1991,91,266,91,208,1991,58,91,188,185,182,91,91,266,58,28,28,1,91,4,4,4,4,3,6,2,2,2,3,3,1,2023-12-21 14:42:00,0
5631,5631,5631,5631,2022,94,292,94,216,2022,76,94,188,184,182,94,94,292,76,36,36,0,94,8,4,4,4,4,4,2,2,2,4,4,0,2023-12-21 14:44:00,12
5637,5638,5638,5638,2025,80,300,80,221,2025,79,80,186,185,184,80,80,300,79,31,31,0,80,7,7,7,7,7,2,2,2,2,1,1,0,2023-12-21 14:46:00,0
5637,5636,5636,5636,2022,97,267,97,219,2022,48,97,196,191,188,97,97,267,48,28,28,0,97,4,4,4,4,4,6,2,2,2,5,5,0,2023-12-21 14:48:00,0
5610,5632,5609,5609,2008,88,321,88,213,2008,108,88,195,192,191,88,88,321,57,28,28,0,88,5,5,4,4,4,2,2,2,2,3,3,0,2023-12-21 14:50:00,52
5076,5078,5078,5078,1945,37,223,37,160,1945,63,37,129,129,129,37,37,223,63,31,31,0,37,7,7,7,7,6,0,2,2,2,0,0,1,2023-12-21 14:52:00,0
5198,5197,5197,5197,2031,24,213,24,146,2031,67,24,123,122,120,24,24,213,67,28,28,0,24,4,4,4,4,4,4,2,2,2,1,1,0,2023-12-21 14:54:00,0
5161,5161,5161,5161,2021,22,192,22,143,2021,49,22,126,122,118,22,22,192,49,27,27,0,22,3,3,3,3,3,8,2,2,2,4,4,0,2023-12-21 14:56:00,0
5202,5202,5202,5202,2038,24,200,24,146,2038,54,24,123,119,118,24,24,200,54,28,28,1,24,4,4,4,4,3,2,2,2,2,4,4,1,2023-12-21 14:58:00,0
5195,5196,5196,5196,2026,24,225,24,152,2026,73,24,124,121,119,24,24,225,73,35,35,7,24,9,8,8,8,8,4,2,2,2,3,3,0,2023-12-21 15:00:00,3
5181,5181,5180,5180,2021,24,407,24,145,2021,262,24,125,121,119,24,24,407,262,27,27,0,24,3,3,3,3,3,4,2,2,2,4,4,0,2023-12-21 15:02:00,0
5192,5193,5192,5192,2036,24,196,24,145,2036,51,24,123,120,118,24,24,196,51,28,28,0,24,4,4,4,4,4,4,2,2,2,3,3,0,2023-12-21 15:04:00,0
5165,5165,5165,5165,2024,24,196,24,145,2024,51,24,121,118,118,24,24,196,51,28,28,0,24,4,4,4,4,4,0,2,2,2,3,3,0,2023-12-21 15:06:00,0
5172,5173,5173,5173,2020,24,218,24,148,2020,70,24,119,118,118,24,24,218,70,31,31,0,24,7,7,7,7,6,0,2,2,2,1,1,1,2023-12-21 15:08:00,0
5179,5179,5179,5179,2026,24,207,24,145,2026,62,24,121,120,119,24,24,207,62,28,28,10,24,4,4,4,4,4,2,2,2,2,1,1,0,2023-12-21 15:10:00,0
5175,5174,5174,5174,2026,24,206,24,147,2026,59,24,122,119,119,24,24,206,59,30,30,0,24,5,4,4,4,3,0,2,2,2,3,3,1,2023-12-21 15:12:00,3
5127,5127,5127,5127,1995,24,229,24,152,1995,77,24,120,117,117,24,24,229,77,36,36,0,24,10,7,7,7,7,0,2,2,2,3,3,0,2023-12-21 15:14:00,9
5173,5172,5172,5172,2018,24,211,24,145,2018,66,24,127,117,117,24,24,211,66,28,28,0,24,4,4,4,4,4,0,2,2,2,10,10,0,2023-12-21 15:16:00,0
5169,5171,5171,5171,2020,24,203,24,144,2020,59,24,125,120,118,24,24,203,59,27,27,0,24,3,3,3,3,3,4,2,2,2,5,5,0,2023-12-21 15:18:00,0
5200,5200,5200,5200,2033,22,212,22,146,2033,66,22,127,123,119,22,22,212,66,28,28,0,22,4,4,4,4,4,8,2,2,2,4,4,0,2023-12-21 15:20:00,0
5185,5184,5184,5184,2024,24,216,24,149,2024,67,24,123,120,118,24,24,216,67,31,31,0,24,7,7,7,7,7,4,2,2,2,3,3,0,2023-12-21 15:22:00,0
5171,5172,5172,5172,2025,24,205,24,145,2025,60,24,121,119,118,24,24,205,60,28,28,0,24,4,4,4,4,3,2,2,2,2,2,2,1,2023-12-21 15:24:00,0
5185,5185,5185,5185,2023,24,215,24,145,2023,70,24,124,119,118,24,24,215,70,28,28,0,24,4,4,4,4,4,2,2,2,2,5,5,0,2023-12-21 15:26:00,0
5201,5200,5200,5200,2036,24,203,24,146,2036,57,24,126,122,119,24,24,203,57,28,28,0,24,4,4,4,4,3,6,2,2,2,4,4,1,2023-12-21 15:28:00,0
5158,5158,5158,5158,2022,24,195,24,148,2022,47,24,119,119,118,24,24,195,47,31,31,0,24,7,7,7,7,7,2,2,2,2,0,0,0,2023-12-21 15:30:00,0
5179,5180,5180,5180,2024,24,212,24,145,2024,67,24,122,120,118,24,24,212,67,28,28,0,24,4,4,4,4,4,4,2,2,2,2,2,0,2023-12-21 15:32:00,0
5172,5172,5172,5172,2025,24,205,24,147,2025,58,24,120,118,118,24,24,205,58,29,29,0,24,4,3,3,3,3,0,2,2,2,2,2,0,2023-12-21 15:34:00,3
5210,5210,5210,5210,2032,24,223,24,149,2032,74,24,127,123,121,24,24,223,74,32,32,0,24,8,8,8,8,8,4,2,2,2,4,4,0,2023-12-21 15:36:00,0
5152,5152,5151,5151,2017,24,204,24,144,2017,60,24,120,119,117,24,24,204,60,27,27,0,24,3,3,3,3,3,4,2,2,2,1,1,0,2023-12-21 15:38:00,0
5176,5177,5177,5177,2022,24,204,24,145,2022,59,24,127,121,119,24,24,204,59,28,28,0,24,4,4,4,4,3,4,2,2,2,6,6,1,2023-12-21 15:40:00,0
5168,5189,5167,5167,2013,24,220,24,145,2013,75,24,122,118,118,24,24,220,75,28,28,0,24,4,4,4,4,4,0,2,2,2,4,4,0,2023-12-21 15:42:00,0
5199,5221,5199,5199,2031,24,214,24,149,2031,65,24,124,120,119,24,24,214,65,31,31,0,24,7,7,7,7,6,2,2,2,2,4,4,1,2023-12-21 15:44:00,0
5188,5189,5189,5189,2027,22,213,22,145,2027,68,22,123,121,118,22,22,213,68,28,28,0,22,4,4,4,4,4,6,2,2,2,2,2,0,2023-12-21 15:46:00,0
5193,5212,5193,5193,2029,24,204,24,146,2029,58,24,127,119,119,24,24,204,58,28,28,0,24,4,4,4,4,4,0,2,2,2,8,8,0,2023-12-21 15:48:00,0
5183,5183,5183,5183,2021,24,271,24,148,2021,123,24,125,122,118,24,24,271,72,32,32,0,24,8,8,7,7,7,8,2,2,2,3,3,0,2023-12-21 15:50:00,52
5190,5190,5190,5190,2028,24,206,24,146,2028,60,24,126,121,119,24,24,206,60,28,28,0,24,4,4,4,4,4,4,2,2,2,5,5,0,2023-12-21 15:52:00,0
5199,5199,5199,5199,2034,24,206,24,144,2034,62,24,126,122,118,24,24,206,62,27,27,0,24,3,3,3,3,3,8,2,2,2,4,4,0,2023-12-21 15:54:00,0
5192,5192,5192,5192,2020,24,221,24,145,2020,76,24,128,122,118,24,24,221,76,28,28,0,24,4,4,4,4,3,8,2,2,2,6,6,1,2023-12-21 15:56:00,0
5183,5183,5183,5183,2019,24,224,24,148,2019,76,24,124,121,118,24,24,224,76,31,31,0,24,7,7,7,7,7,6,2,2,2,3,3,0,2023-12-21 15:58:00,0
5189,5189,5189,5189,2029,24,205,24,145,2029,60,24,123,120,118,24,24,205,60,28,28,0,24,4,4,4,4,3,4,2,2,2,3,3,1,2023-12-21 16:00:00,0
5129,5127,5127,5127,2000,24,208,24,145,2000,63,24,123,120,119,24,24,208,63,28,28,5,24,4,4,4,4,4,2,2,2,2,3,3,0,2023-12-21 16:02:00,0
5215,5235,5216,5216,2044,24,208,24,146,2044,62,24,122,121,119,24,24,208,62,28,28,0,24,4,4,4,4,4,4,2,2,2,1,1,0,2023-12-21 16:04:00,0
5222,5223,5223,5223,2035,24,234,24,149,2035,85,24,126,120,119,24,24,234,85,31,31,0,24,7,7,7,7,7,2,2,2,2,6,6,0,2023-12-21 16:06:00,0
5191,5191,5191,5191,2024,24,211,24,144,2024,67,24,126,119,118,24,24,211,67,28,28,0,24,4,4,4,4,4,2,2,2,2,7,7,0,2023-12-21 16:08:00,0
5197,5197,5197,5197,2032,24,209,24,146,2032,63,24,127,120,119,24,24,209,63,28,28,0,24,4,4,4,4,3,2,2,2,2,7,7,1,2023-12-21 16:10:00,0
5183,5182,5182,5182,2028,22,212,22,148,2028,64,22,120,119,118,22,22,212,64,31,31,0,22,7,7,7,7,7,2,2,2,2,1,1,0,2023-12-21 16:12:00,0
5197,5198,5198,5198,2030,24,209,24,144,2030,65,24,129,122,120,24,24,209,65,27,27,0,24,3,3,3,3,3,4,2,2,2,7,7,0,2023-12-21 16:14:00,0
5166,5166,5166,5166,2019,24,209,24,145,2019,64,24,124,120,118,24,24,209,64,28,28,0,24,4,4,4,4,3,4,2,2,2,4,4,1,2023-12-21 16:16:00,0
5201,5200,5200,5200,2031,24,209,24,145,2031,64,24,127,124,118,24,24,209,64,28,28,0,24,4,4,4,4,4,12,2,2,2,3,3,0,2023-12-21 16:18:00,0
5173,5174,5174,5174,2018,24,212,24,148,2018,64,24,127,121,118,24,24,212,64,31,31,0,24,7,7,7,7,7,6,2,2,2,6,6,0,2023-12-21 16:20:00,0
5169,5168,5168,5168,2016,24,209,24,145,2016,64,24,125,121,118,24,24,209,64,28,28,0,24,4,4,4,4,4,6,2,2,2,4,4,0,2023-12-21 16:22:00,0
5182,5183,5183,5183,2029,24,205,24,145,2029,60,24,121,119,119,24,24,205,60,28,28,0,24,4,4,4,4,4,0,2,2,2,2,2,0,2023-12-21 16:24:00,0
5112,5112,5112,5112,1999,24,200,24,144,1999,56,24,122,118,118,24,24,200,56,28,28,0,24,4,4,4,4,3,0,2,2,2,4,4,1,2023-12-21 16:26:00,0
5169,5169,5169,5169,2025,24,200,24,150,2025,50,24,122,119,118,24,24,200,50,33,33,0,24,8,7,7,7,7,2,2,2,2,3,3,0,2023-12-21 16:28:00,3
5173,5173,5173,5173,2025,24,199,24,144,2025,55,24,123,122,119,24,24,199,55,27,27,4,24,3,3,3,3,3,6,2,2,2,1,1,0,2023-12-21 16:30:00,0
5162,5162,5162,5162,2020,24,198,24,145,2020,53,24,123,120,118,24,24,198,53,28,28,0,24,4,4,4,4,3,4,2,2,2,3,3,1,2023-12-21 16:32:00,0
5174,5171,5171,5171,2029,24,197,24,149,2029,48,24,121,118,118,24,24,197,48,32,32,0,24,8,8,8,8,8,0,2,2,2,3,3,0,2023-12-21 16:34:00,0
5155,5158,5158,5158,2019,22,194,22,144,2019,50,22,121,118,118,22,22,194,50,27,27,0,22,3,3,3,3,3,0,2,2,2,3,3,0,2023-12-21 16:36:00,0
5203,5203,5203,5203,2036,24,210,24,145,2036,65,24,124,118,118,24,24,210,65,28,28,0,24,4,4,4,4,4,0,2,2,2,6,6,0,2023-12-21 16:38:00,0
5185,5184,5184,5184,2030,24,202,24,145,2030,57,24,125,121,119,24,24,202,57,28,28,0,24,4,4,4,4,4,4,2,2,2,4,4,0,2023-12-21 16:40:00,0
5205,5206,5206,5206,2024,24,235,24,149,2024,86,24,124,121,118,24,24,235,86,31,31,0,24,7,7,7,7,6,6,2,2,2,3,3,1,2023-12-21 16:42:00,0
5198,5197,5197,5197,2037,24,201,24,146,2037,55,24,123,120,119,24,24,201,55,28,28,12,24,4,4,4,4,4,2,2,2,2,3,3,0,2023-12-21 16:44:00,0
5170,5171,5171,5171,2022,24,204,24,145,2022,59,24,124,119,118,24,24,204,59,28,28,0,24,4,4,4,4,3,2,2,2,2,5,5,1,2023-12-21 16:46:00,0
5165,5165,5165,5165,2024,24,196,24,148,2024,48,24,121,120,118,24,24,196,48,31,31,0,24,7,7,7,7,7,4,2,2,2,1,1,0,2023-12-21 16:48:00,0
5143,5143,5143,5143,2012,24,256,24,145,2012,111,24,122,118,118,24,24,256,60,29,29,0,24,5,5,4,4,4,0,2,2,2,4,4,0,2023-12-21 16:50:00,52
5908,5909,5909,5909,2319,26,277,26,218,2319,59,26,138,136,135,26,26,277,59,84,83,0,26,29,3,3,3,3,2,3,3,3,2,2,0,2023-12-21 16:52:00,81
5195,5194,5194,5194,2034,24,306,24,250,2034,56,24,126,123,120,24,24,306,56,132,133,0,24,57,4,4,4,4,6,2,2,2,3,3,0,2023-12-21 16:54:00,156
5198,5199,5199,5199,2030,24,215,24,149,2030,66,24,123,119,118,24,24,215,66,31,31,9,24,7,7,7,7,7,2,2,2,2,4,4,0,2023-12-21 16:56:00,0
5146,5146,5146,5146,2006,24,217,24,144,2006,73,24,123,119,117,24,24,217,73,28,28,11,24,4,4,4,4,3,4,2,2,2,4,4,1,2023-12-21 16:58:00,0
5184,5183,5183,5183,2025,24,208,24,145,2025,63,24,127,121,119,24,24,208,63,28,28,0,24,4,4,4,4,4,4,2,2,2,6,6,0,2023-12-21 17:00:00,0
5153,5153,5153,5153,2009,22,211,22,144,2009,67,22,121,120,118,22,22,211,67,28,28,13,22,4,4,4,4,3,4,2,2,2,1,1,1,2023-12-21 17:02:00,0
5192,5214,5193,5193,2030,24,217,24,149,2030,68,24,123,120,119,24,24,217,68,31,31,1,24,7,7,7,7,7,2,2,2,2,3,3,0,2023-12-21 17:04:00,0
5158,5168,5158,5158,2021,24,191,24,145,2021,46,24,120,118,118,24,24,191,46,28,28,0,24,4,4,4,4,4,0,2,2,2,2,2,0,2023-12-21 17:06:00,0
5164,5166,5164,5164,2022,24,197,24,144,2022,53,24,123,121,118,24,24,197,53,27,27,0,24,3,3,3,3,3,6,2,2,2,2,2,0,2023-12-21 17:08:00,0
5150,5150,5150,5150,2018,24,187,24,144,2018,43,24,122,118,118,24,24,187,43,28,28,0,24,4,4,4,4,4,0,2,2,2,4,4,0,2023-12-21 17:10:00,0
5189,5189,5189,5189,2029,24,214,24,149,2029,65,24,123,119,119,24,24,214,65,31,31,0,24,7,7,7,7,7,0,2,2,2,4,4,0,2023-12-21 17:12:00,0
5187,5186,5186,5186,2026,24,210,24,144,2026,66,24,126,121,119,24,24,210,66,28,28,0,24,4,4,4,4,3,4,2,2,2,5,5,1,2023-12-21 17:14:00,0
5195,5200,5196,5196,2027,24,214,24,146,2027,68,24,127,120,118,24,24,214,68,28,28,0,24,4,4,4,4,4,4,2,2,2,7,7,0,2023-12-21 17:16:00,0
5195,5195,5195,5195,2030,24,212,24,148,2030,64,24,126,122,119,24,24,212,64,31,31,4,24,7,7,7,7,6,6,2,2,2,4,4,1,2023-12-21 17:18:00,0
5107,5107,5107,5107,2004,24,182,24,144,2004,38,24,122,119,117,24,24,182,38,28,28,0,24,4,4,4,4,4,4,2,2,2,3,3,0,2023-12-21 17:20:00,0
5175,5175,5175,5175,2015,24,214,24,145,2015,69,24,126,121,118,24,24,214,69,28,28,0,24,4,4,4,4,4,6,2,2,2,5,5,0,2023-12-21 17:22:00,0
5181,5180,5180,5180,2031,24,189,24,144,2031,45,24,126,120,119,24,24,189,45,27,27,0,24,3,3,3,3,3,2,2,2,2,6,6,0,2023-12-21 17:24:00,0
5208,5208,5208,5208,2034,24,221,24,150,2034,71,24,120,118,118,24,24,221,71,32,32,0,24,8,8,8,8,8,0,2,2,2,2,2,0,2023-12-21 17:26:00,0
5187,5188,5188,5188,2030,22,203,22,144,2030,59,22,124,121,119,22,22,203,59,27,27,0,22,3,3,3,3,3,4,2,2,2,3,3,0,2023-12-21 17:28:00,0
5184,5184,5184,5184,2030,24,195,24,145,2030,50,24,124,121,118,24,24,195,50,28,28,0,24,4,4,4,4,3,6,2,2,2,3,3,1,2023-12-21 17:30:00,0
5174,5172,5172,5172,2032,24,186,24,146,2032,40,24,122,118,118,24,24,186,40,28,28,4,24,4,4,4,4,4,0,2,2,2,4,4,0,2023-12-21 17:32:00,0
5187,5189,5189,5189,2033,24,200,24,149,2033,51,24,123,121,119,24,24,200,51,31,31,0,24,7,7,7,7,6,4,2,2,2,2,2,1,2023-12-21 17:34:00,0
5168,5188,5167,5167,2023,24,198,24,147,2023,51,24,123,121,119,24,24,198,51,30,30,0,24,5,4,4,4,4,4,2,2,2,2,2,0,2023-12-21 17:36:00,3
5225,5229,5225,5225,2030,24,239,24,145,2030,94,24,121,119,118,24,24,239,94,28,28,0,24,4,4,4,4,4,2,2,2,2,2,2,0,2023-12-21 17:38:00,0
5203,5204,5204,5204,2040,24,212,24,151,2040,61,24,122,121,119,24,24,212,61,33,33,0,24,8,7,7,7,7,4,2,2,2,1,1,0,2023-12-21 17:40:00,3
5159,5159,5159,5159,2016,24,197,24,145,2016,52,24,126,119,118,24,24,197,52,28,28,0,24,4,4,4,4,4,2,2,2,2,7,7,0,2023-12-21 17:42:00,0
5123,5123,5123,5123,2004,24,198,24,142,2004,56,24,121,117,117,24,24,198,56,26,26,0,24,3,3,3,3,3,0,2,2,2,4,4,0,2023-12-21 17:44:00,0
5166,5166,5166,5166,2013,24,211,24,144,2013,67,24,124,121,118,24,24,211,67,28,28,0,24,4,4,4,4,3,6,2,2,2,3,3,1,2023-12-21 17:46:00,0
5191,5190,5190,5190,2025,24,220,24,148,2025,72,24,123,122,118,24,24,220,72,31,31,10,24,7,7,7,7,7,8,2,2,2,1,1,0,2023-12-21 17:48:00,0
5204,5205,5205,5205,2037,24,258,24,147,2037,111,24,123,121,119,24,24,258,60,29,29,0,24,5,5,4,4,3,4,2,2,2,2,2,1,2023-12-21 17:50:00,52
5188,5188,5188,5188,2024,24,214,24,145,2024,69,24,124,121,118,24,24,214,69,28,28,0,24,4,4,4,4,4,6,2,2,2,3,3,0,2023-12-21 17:52:00,0
5197,5196,5196,5196,2033,24,210,23,146,2033,64,23,122,120,119,23,23,210,64,28,28,0,23,4,4,4,4,4,2,2,2,2,2,2,0,2023-12-21 17:54:00,0
5193,5194,5194,5194,2033,22,215,23,148,2033,67,23,119,118,118,23,23,215,67,31,31,0,23,7,7,7,7,7,0,2,2,2,1,1,0,2023-12-21 17:56:00,0
5186,5186,5186,5186,2024,24,219,24,145,2024,74,24,119,118,118,24,24,219,74,28,28,0,24,4,4,4,4,4,0,2,2,2,1,1,0,2023-12-21 17:58:00,0
5147,5146,5146,5146,2010,24,202,24,145,2010,57,24,119,118,118,24,24,202,57,28,28,0,24,4,4,4,4,3,0,2,2,2,1,1,1,2023-12-21 18:00:00,0
5142,5142,5142,5142,2003,24,410,24,143,2003,267,24,119,118,118,24,24,410,267,27,27,0,24,3,3,3,3,3,0,2,2,2,1,1,0,2023-12-21 18:02:00,0
5143,5144,5144,5144,2013,24,195,24,148,2013,47,24,125,120,117,24,24,195,47,31,31,0,24,7,7,7,7,7,6,2,2,2,5,5,0,2023-12-21 18:04:00,0
5192,5192,5192,5192,2031,24,206,24,145,2031,61,24,124,123,119,24,24,206,61,28,28,0,24,4,4,4,4,3,8,2,2,2,1,1,1,2023-12-21 18:06:00,0
5182,5182,5182,5182,2033,24,201,24,146,2033,55,24,119,119,118,24,24,201,55,29,29,0,24,4,4,4,4,4,2,2,2,2,0,0,0,2023-12-21 18:08:00,0
5135,5136,5135,5135,2010,24,200,24,147,2010,53,24,123,118,117,24,24,200,53,30,30,0,24,7,7,7,7,7,2,2,2,2,5,5,0,2023-12-21 18:10:00,0
5176,5176,5176,5176,2017,24,212,24,144,2017,68,24,125,120,119,24,24,212,68,28,28,0,24,4,4,4,4,4,2,2,2,2,5,5,0,2023-12-21 18:12:00,0
5212,5233,5211,5211,2035,24,221,24,146,2035,75,24,121,120,119,24,24,221,75,28,28,0,24,4,4,4,4,4,2,2,2,2,1,1,0,2023-12-21 18:14:00,0
5197,5197,5197,5197,2030,24,211,24,145,2030,66,24,123,118,118,24,24,211,66,28,28,0,24,4,4,4,4,3,0,2,2,2,5,5,1,2023-12-21 18:16:00,0
5186,5189,5187,5187,2027,24,213,24,148,2027,65,24,122,119,118,24,24,213,65,31,31,0,24,7,7,7,7,7,2,2,2,2,3,3,0,2023-12-21 18:18:00,0
5176,5178,5176,5176,2030,24,198,24,145,2030,53,24,121,119,118,24,24,198,53,27,27,0,24,3,3,3,3,3,2,2,2,2,2,2,0,2023-12-21 18:20:00,2
5177,5177,5177,5177,2018,22,215,22,145,2018,70,22,123,118,118,22,22,215,70,28,28,0,22,4,4,4,4,3,0,2,2,2,5,5,1,2023-12-21 18:22:00,0
5193,5193,5193,5193,2033,24,202,24,146,2033,56,24,125,120,119,24,24,202,56,28,28,0,24,4,4,4,4,4,2,2,2,2,5,5,0,2023-12-21 18:24:00,0
5212,5211,5211,5211,2031,24,228,24,148,2031,80,24,123,122,119,24,24,228,80,31,31,0,24,7,7,7,7,7,6,2,2,2,1,1,0,2023-12-21 18:26:00,0
5166,5167,5167,5167,2017,24,205,24,145,2017,60,24,123,120,118,24,24,205,60,28,28,0,24,4,4,4,4,4,4,2,2,2,3,3,0,2023-12-21 18:28:00,0
5197,5197,5197,5197,2030,24,210,24,146,2030,64,24,124,121,119,24,24,210,64,28,28,0,24,4,4,4,4,4,4,2,2,2,3,3,0,2023-12-21 18:30:00,0
5129,5129,5129,5129,2009,24,207,24,147,2009,60,24,119,118,117,24,24,207,60,31,31,10,24,7,7,7,7,6,2,2,2,2,1,1,1,2023-12-21 18:32:00,0
5150,5149,5149,5149,2020,24,183,24,144,2020,39,24,121,120,118,24,24,183,39,28,28,0,24,4,4,4,4,4,4,2,2,2,1,1,0,2023-12-21 18:34:00,0
5198,5196,5196,5196,2037,24,200,24,145,2037,55,24,122,120,119,24,24,200,55,27,27,0,24,3,3,3,3,3,2,2,2,2,2,2,0,2023-12-21 18:36:00,0
5177,5180,5180,5180,2027,24,199,24,145,2027,54,24,124,123,120,24,24,199,54,28,28,0,24,4,4,4,4,3,6,2,2,2,1,1,1,2023-12-21 18:38:00,0
5210,5210,5210,5210,2042,24,212,24,150,2042,62,24,120,119,118,24,24,212,62,32,32,0,24,8,8,8,8,8,2,2,2,2,1,1,0,2023-12-21 18:40:00,0
5195,5195,5195,5195,2023,24,222,24,145,2023,77,24,123,120,119,24,24,222,77,27,27,0,24,3,3,3,3,3,2,2,2,2,3,3,0,2023-12-21 18:42:00,0
5171,5170,5170,5170,2020,24,209,24,144,2020,65,24,122,119,118,24,24,209,65,28,28,0,24,4,4,4,4,4,2,2,2,2,3,3,0,2023-12-21 18:44:00,0
5183,5182,5182,5182,2023,24,206,24,146,2023,60,24,125,119,118,24,24,206,60,28,28,0,24,4,4,4,4,4,2,2,2,2,6,6,0,2023-12-21 18:46:00,0
5182,5184,5184,5184,2015,22,234,22,147,2015,87,22,125,120,119,22,22,234,87,31,31,0,22,7,7,7,7,6,2,2,2,2,5,5,1,2023-12-21 18:48:00,0
5196,5196,5196,5196,2035,24,254,24,147,2035,107,24,121,119,119,24,24,254,56,29,29,0,24,5,5,4,4,4,0,2,2,2,2,2,0,2023-12-21 18:50:00,52
5177,5197,5176,5176,2029,24,194,24,145,2029,49,24,123,120,119,24,24,194,49,28,28,0,24,4,4,4,4,3,2,2,2,2,3,3,1,2023-12-21 18:52:00,0
5183,5184,5184,5184,2026,24,213,24,148,2026,65,24,122,119,118,24,24,213,65,31,31,0,24,7,7,7,7,7,2,2,2,2,3,3,0,2023-12-21 18:54:00,0
5181,5181,5181,5181,2024,24,204,24,145,2024,59,24,126,123,119,24,24,204,59,28,28,0,24,4,4,4,4,4,8,2,2,2,3,3,0,2023-12-21 18:56:00,0
5143,5144,5142,5142,2004,24,218,24,143,2004,75,24,120,117,117,24,24,218,75,27,27,0,24,3,3,3,3,3,0,2,2,2,3,3,0,2023-12-21 18:58:00,0
5175,5176,5176,5176,2026,24,200,24,145,2026,55,24,121,118,118,24,24,200,55,28,28,0,24,4,4,4,4,4,0,2,2,2,3,3,0,2023-12-21 19:00:00,0
5173,5173,5173,5173,2016,24,218,24,148,2016,70,24,123,121,118,24,24,218,70,31,31,0,24,7,7,7,7,7,6,2,2,2,2,2,0,2023-12-21 19:02:00,0
5216,5216,5216,5216,2036,24,227,24,152,2036,75,24,122,121,119,24,24,227,75,34,34,0,24,7,4,4,4,3,4,2,2,2,1,1,1,2023-12-21 19:04:00,9
5174,5172,5172,5172,2023,24,205,24,145,2023,60,24,122,120,119,24,24,205,60,28,28,0,24,4,4,4,4,4,2,2,2,2,2,2,0,2023-12-21 19:06:00,0
5173,5175,5175,5175,2022,24,201,24,145,2022,56,24,121,119,118,24,24,201,56,28,28,0,24,4,4,4,4,3,2,2,2,2,2,2,1,2023-12-21 19:08:00,0
5177,5177,5177,5177,2028,24,208,24,148,2028,60,24,122,119,118,24,24,208,60,31,31,0,24,7,7,7,7,7,2,2,2,2,3,3,0,2023-12-21 19:10:00,0
5204,5202,5202,5202,2028,24,225,24,145,2028,80,24,123,121,119,24,24,225,80,28,28,10,24,4,4,4,4,4,4,2,2,2,2,2,0,2023-12-21 19:12:00,0
5200,5202,5202,5202,2026,22,222,22,144,2026,78,22,126,122,119,22,22,222,78,27,27,10,22,3,3,3,3,3,6,2,2,2,4,4,0,2023-12-21 19:14:00,0
5176,5175,5175,5175,2028,24,201,24,149,2028,52,24,121,119,118,24,24,201,52,32,32,0,24,8,8,8,8,8,2,2,2,2,2,2,0,2023-12-21 19:16:00,0
5192,5193,5193,5193,2026,24,210,24,144,2026,66,24,128,122,118,24,24,210,66,27,27,0,24,3,3,3,3,3,8,2,2,2,6,6,0,2023-12-21 19:18:00,0
5203,5203,5203,5203,2031,24,215,24,145,2031,70,24,127,121,120,24,24,215,70,28,28,16,24,4,4,4,4,3,2,2,2,2,6,6,1,2023-12-21 19:20:00,0
5140,5139,5139,5139,2007,24,203,24,145,2007,58,24,126,121,118,24,24,203,58,28,28,0,24,4,4,4,4,4,6,2,2,2,5,5,0,2023-12-21 19:22:00,0
5203,5202,5202,5202,2037,24,213,24,148,2037,65,24,121,119,118,24,24,213,65,31,31,0,24,7,7,7,7,6,2,2,2,2,2,2,1,2023-12-21 19:24:00,0
5200,5203,5202,5202,2033,24,214,24,146,2033,68,24,123,120,119,24,24,214,68,28,28,0,24,4,4,4,4,4,2,2,2,2,3,3,0,2023-12-21 19:26:00,0
5178,5178,5178,5178,2017,24,217,24,145,2017,72,24,121,121,118,24,24,217,72,28,28,0,24,4,4,4,4,4,6,2,2,2,0,0,0,2023-12-21 19:28:00,0
5161,5160,5160,5160,2020,24,194,24,144,2020,50,24,121,118,118,24,24,194,50,27,27,0,24,3,3,3,3,3,0,2,2,2,3,3,0,2023-12-21 19:30:00,0
5164,5165,5165,5165,2022,24,199,24,149,2022,50,24,125,118,118,24,24,199,50,32,32,0,24,8,8,8,8,8,0,2,2,2,7,7,0,2023-12-21 19:32:00,0
5191,5190,5190,5190,2031,24,201,24,144,2031,57,24,126,121,118,24,24,201,57,27,27,0,24,3,3,3,3,3,6,2,2,2,5,5,0,2023-12-21 19:34:00,0
5183,5184,5184,5184,2022,24,221,24,145,2022,76,24,121,120,119,24,24,221,76,28,28,3,24,4,4,4,4,3,2,2,2,2,1,1,1,2023-12-21 19:36:00,0
5173,5171,5171,5171,2030,24,192,24,148,2030,44,24,124,120,118,24,24,192,44,31,31,0,24,7,7,7,7,7,4,2,2,2,4,4,0,2023-12-21 19:38:00,0
5199,5200,5200,5200,2028,24,216,23,145,2028,71,23,123,120,119,23,23,216,71,28,28,0,23,4,4,4,4,3,2,2,2,2,3,3,1,2023-12-21 19:40:00,0
5165,5166,5166,5166,2020,22,205,23,146,2020,59,23,120,119,118,23,23,205,59,28,28,0,23,4,4,4,4,4,2,2,2,2,1,1,0,2023-12-21 19:42:00,0
5166,5166,5166,5166,2019,24,201,24,144,2019,57,24,120,119,118,24,24,201,57,28,28,0,24,4,4,4,4,4,2,2,2,2,1,1,0,2023-12-21 19:44:00,0
5140,5139,5139,5139,2008,24,213,24,147,2008,66,24,119,117,117,24,24,213,66,31,31,0,24,7,7,7,7,7,0,2,2,2,2,2,0,2023-12-21 19:46:00,0
5180,5181,5181,5181,2029,24,200,24,146,2029,54,24,126,121,119,24,24,200,54,28,28,0,24,4,4,4,4,4,4,2,2,2,5,5,0,2023-12-21 19:48:00,0
5165,5165,5164,5164,2025,24,240,24,145,2025,95,24,120,118,118,24,24,240,44,28,28,0,24,4,4,3,3,3,0,2,2,2,2,2,0,2023-12-21 19:50:00,52
5200,5201,5201,5201,2029,24,208,24,145,2029,63,24,127,120,118,24,24,208,63,28,28,0,24,4,4,4,4,3,4,2,2,2,7,7,1,2023-12-21 19:52:00,0
5192,5192,5192,5192,2027,24,215,24,148,2027,67,24,125,121,119,24,24,215,67,31,31,0,24,7,7,7,7,7,4,2,2,2,4,4,0,2023-12-21 19:54:00,0
5167,5166,5166,5166,2022,24,197,24,145,2022,52,24,121,120,118,24,24,197,52,28,28,0,24,4,4,4,4,3,4,2,2,2,1,1,1,2023-12-21 19:56:00,0
5202,5203,5203,5203,2029,24,217,24,146,2029,71,24,124,122,118,24,24,217,71,28,28,4,24,4,4,4,4,4,8,2,2,2,2,2,0,2023-12-21 19:58:00,0
5179,5179,5179,5179,2033,24,196,24,148,2033,48,24,123,121,119,24,24,196,48,31,31,0,24,7,7,7,7,7,4,2,2,2,2,2,0,2023-12-21 20:00:00,0
5164,5163,5163,5163,2010,24,317,24,145,2010,172,24,123,119,118,24,24,317,172,28,28,0,24,4,4,4,4,4,2,2,2,2,4,4,0,2023-12-21 20:02:00,0
5208,5209,5209,5209,2037,24,212,24,146,2037,66,24,123,120,119,24,24,212,66,28,28,0,24,4,4,4,4,4,2,2,2,2,3,3,0,2023-12-21 20:04:00,0
5159,5158,5158,5158,2023,24,189,24,145,2023,44,24,124,120,118,24,24,189,44,28,28,0,24,4,4,4,4,3,4,2,2,2,4,4,1,2023-12-21 20:06:00,0
5173,5174,5174,5174,2031,22,195,22,148,2031,47,22,122,120,118,22,22,195,47,31,31,0,22,7,7,7,7,7,4,2,2,2,2,2,0,2023-12-21 20:08:00,0
5144,5144,5144,5144,2006,24,210,24,143,2006,67,24,125,121,118,24,24,210,67,27,27,0,24,3,3,3,3,3,6,2,2,2,4,4,0,2023-12-21 20:10:00,0
5212,5212,5211,5211,2027,24,235,24,145,2027,90,24,124,120,119,24,24,235,90,28,28,0,24,4,4,4,4,3,2,2,2,2,4,4,1,2023-12-21 20:12:00,0
5180,5179,5179,5179,2028,24,202,24,146,2028,56,24,121,121,118,24,24,202,56,28,28,0,24,4,4,4,4,4,6,2,2,2,0,0,0,2023-12-21 20:14:00,0
5177,5179,5179,5179,2027,24,199,24,141,2027,58,24,123,121,119,24,24,199,58,24,24,0,24,0,0,0,0,0,4,2,2,2,2,2,0,2023-12-21 20:16:00,0
5201,5201,5201,5201,2032,24,206,24,141,2032,65,24,124,119,119,24,24,206,65,24,24,0,24,0,0,0,0,0,0,2,2,2,5,5,0,2023-12-21 20:18:00,0
5180,5199,5179,5179,2023,24,208,24,145,2023,63,24,124,121,118,24,24,208,63,28,28,0,24,4,4,4,4,4,6,2,2,2,3,3,0,2023-12-21 20:20:00,0
5160,5160,5160,5160,2016,24,201,24,144,2016,57,24,123,119,118,24,24,201,57,27,27,0,24,3,3,3,3,3,2,2,2,2,4,4,0,2023-12-21 20:22:00,0
5194,5195,5195,5195,2028,24,217,24,150,2028,67,24,122,120,118,24,24,217,67,32,32,0,24,8,8,8,8,8,4,2,2,2,2,2,0,2023-12-21 20:24:00,0
5174,5173,5173,5173,2028,24,190,24,144,2028,46,24,124,120,118,24,24,190,46,27,27,0,24,3,3,3,3,3,4,2,2,2,4,4,0,2023-12-21 20:26:00,0
5159,5160,5160,5160,2023,24,189,24,145,2023,44,24,123,121,119,24,24,189,44,28,28,0,24,4,4,4,4,3,4,2,2,2,2,2,1,2023-12-21 20:28:00,0
5204,5204,5204,5204,2027,24,222,24,145,2027,77,24,125,119,118,24,24,222,77,28,28,0,24,4,4,4,4,4,2,2,2,2,6,6,0,2023-12-21 20:30:00,0
5116,5114,5114,5114,2001,22,199,22,146,2001,53,22,122,117,117,22,22,199,53,30,30,0,22,7,7,7,7,6,0,2,2,2,5,5,1,2023-12-21 20:32:00,0
5189,5189,5189,5189,2036,24,202,24,145,2036,57,24,118,118,118,24,24,202,57,28,28,0,24,4,4,4,4,4,0,2,2,2,0,0,0,2023-12-21 20:34:00,0
5168,5169,5169,5169,2023,24,192,24,145,2023,47,24,122,120,119,24,24,192,47,28,28,0,24,4,4,4,4,4,2,2,2,2,2,2,0,2023-12-21 20:36:00,0
5168,5169,5169,5169,2026,24,192,24,149,2026,43,24,124,120,118,24,24,192,43,31,31,0,24,7,7,7,7,7,4,2,2,2,4,4,0,2023-12-21 20:38:00,0
5171,5171,5171,5171,2027,24,195,24,145,2027,50,24,121,118,118,24,24,195,50,28,28,0,24,4,4,4,4,4,0,2,2,2,3,3,0,2023-12-21 20:40:00,0
5146,5145,5145,5145,2001,24,206,24,143,2001,63,24,126,120,119,24,24,206,63,27,27,0,24,3,3,3,3,3,2,2,2,2,6,6,0,2023-12-21 20:42:00,0
5190,5190,5190,5190,2029,24,205,24,145,2029,60,24,126,120,118,24,24,205,60,28,28,0,24,4,4,4,4,3,4,2,2,2,6,6,1,2023-12-21 20:44:00,0
5200,5219,5200,5200,2026,24,215,24,148,2026,67,24,129,121,119,24,24,215,67,31,31,0,24,7,7,7,7,7,4,2,2,2,8,8,0,2023-12-21 20:46:00,0
5173,5174,5174,5174,2021,24,207,24,145,2021,62,24,123,120,118,24,24,207,62,28,28,0,24,4,4,4,4,3,4,2,2,2,3,3,1,2023-12-21 20:48:00,0
5159,5159,5159,5159,2018,24,252,24,146,2018,106,24,120,120,118,24,24,252,55,29,29,0,24,5,5,4,4,4,4,2,2,2,0,0,0,2023-12-21 20:50:00,52
5183,5183,5183,5183,2015,24,227,24,147,2015,80,24,124,119,118,24,24,227,80,31,31,0,24,7,7,7,7,7,2,2,2,2,5,5,0,2023-12-21 20:52:00,0
5187,5187,5187,5187,2030,24,203,24,146,2030,57,24,121,120,118,24,24,203,57,28,28,0,24,4,4,4,4,4,4,2,2,2,1,1,0,2023-12-21 20:54:00,0
5143,5143,5143,5143,2010,24,204,24,144,2010,60,24,121,119,118,24,24,204,60,28,28,0,24,4,4,4,4,4,2,2,2,2,2,2,0,2023-12-21 20:56:00,0
5198,5196,5196,5196,2033,22,213,22,145,2033,68,22,119,118,118,22,22,213,68,28,28,0,22,4,4,4,4,3,0,2,2,2,1,1,1,2023-12-21 20:58:00,0
5169,5171,5171,5171,2026,24,199,24,149,2026,50,24,120,118,118,24,24,199,50,31,31,0,24,7,7,7,7,7,0,2,2,2,2,2,0,2023-12-21 21:00:00,0
5146,5146,5146,5146,2005,24,310,24,143,2005,167,24,121,119,118,24,24,310,167,27,27,0,24,3,3,3,3,3,2,2,2,2,2,2,0,2023-12-21 21:02:00,0
5152,5152,5152,5152,2017,24,196,24,144,2017,52,24,122,118,118,24,24,196,52,28,28,0,24,4,4,4,4,3,0,2,2,2,4,4,1,2023-12-21 21:04:00,0
5217,5216,5216,5216,2027,24,240,24,145,2027,95,24,121,118,118,24,24,240,95,28,28,0,24,4,4,4,4,4,0,2,2,2,3,3,0,2023-12-21 21:06:00,0
5172,5172,5172,5172,2023,24,203,24,148,2023,55,24,123,121,119,24,24,203,55,31,31,0,24,7,7,7,7,7,4,2,2,2,2,2,0,2023-12-21 21:08:00,0
5206,5206,5206,5206,2040,24,201,24,146,2040,55,24,123,120,119,24,24,201,55,28,28,0,24,4,4,4,4,4,2,2,2,2,3,3,0,2023-12-21 21:10:00,0
5168,5169,5169,5169,2024,24,195,24,145,2024,50,24,123,120,118,24,24,195,50,28,28,10,24,4,4,4,4,4,4,2,2,2,3,3,0,2023-12-21 21:12:00,0
5170,5169,5169,5169,2023,24,202,24,148,2023,54,24,125,121,118,24,24,202,54,31,31,0,24,7,7,7,7,6,6,2,2,2,4,4,1,2023-12-21 21:14:00,0
5185,5185,5185,5185,2027,24,206,24,145,2027,61,24,123,120,118,24,24,206,61,28,28,4,24,4,4,4,4,4,4,2,2,2,3,3,0,2023-12-21 21:16:00,0
5202,5203,5203,5203,2035,24,209,24,146,2035,63,24,123,120,120,24,24,209,63,28,28,0,24,4,4,4,4,3,0,2,2,2,3,3,1,2023-12-21 21:18:00,0
5138,5138,5138,5138,2015,24,191,24,144,2015,47,24,121,120,118,24,24,191,47,27,27,0,24,3,3,3,3,3,4,2,2,2,1,1,0,2023-12-21 21:20:00,0
5151,5150,5150,5150,2008,24,209,24,148,2008,61,24,124,120,117,24,24,209,61,32,32,0,24,8,8,8,8,8,6,2,2,2,4,4,0,2023-12-21 21:22:00,0
5196,5197,5197,5197,2032,22,208,22,145,2032,63,22,121,119,119,22,22,208,63,27,27,0,22,3,3,3,3,3,0,2,2,2,2,2,0,2023-12-21 21:24:00,0
5190,5190,5189,5189,2031,24,209,24,145,2031,64,24,120,118,118,24,24,209,64,28,28,0,24,4,4,4,4,4,0,2,2,2,2,2,0,2023-12-21 21:26:00,0
5173,5175,5174,5174,2028,24,199,24,148,2028,51,24,121,119,118,24,24,199,51,31,31,0,24,7,7,7,7,7,2,2,2,2,2,2,0,2023-12-21 21:28:00,0
5193,5193,5193,5193,2029,24,203,24,145,2029,58,24,129,120,119,24,24,203,58,28,28,0,24,4,4,4,4,3,2,2,2,2,9,9,1,2023-12-21 21:30:00,0
5164,5162,5162,5162,2023,24,195,24,145,2023,50,24,122,118,118,24,24,195,50,28,28,0,24,4,4,4,4,4,0,2,2,2,4,4,0,2023-12-21 21:32:00,0
5147,5147,5147,5147,2016,24,192,24,145,2016,47,24,121,119,118,24,24,192,47,28,28,0,24,4,4,4,4,3,2,2,2,2,2,2,1,2023-12-21 21:34:00,0
5177,5179,5179,5179,2021,24,214,24,148,2021,66,24,122,119,118,24,24,214,66,31,31,0,24,7,7,7,7,7,2,2,2,2,3,3,0,2023-12-21 21:36:00,0
5197,5197,5197,5197,2029,24,217,24,145,2029,72,24,118,118,118,24,24,217,72,28,28,0,24,4,4,4,4,4,0,2,2,2,0,0,0,2023-12-21 21:38:00,0
5177,5175,5175,5175,2029,24,199,24,144,2029,55,24,119,118,118,24,24,199,55,27,27,0,24,3,3,3,3,3,0,2,2,2,1,1,0,2023-12-21 21:40:00,0
5203,5205,5205,5205,2029,24,222,24,150,2029,72,24,125,120,119,24,24,222,72,32,32,0,24,8,8,8,8,8,2,2,2,2,5,5,0,2023-12-21 21:42:00,0
5145,5144,5144,5144,2008,24,214,24,143,2008,71,24,120,118,117,24,24,214,71,27,27,0,24,3,3,3,3,3,2,2,2,2,2,2,0,2023-12-21 21:44:00,0
5177,5197,5177,5177,2023,24,208,24,145,2023,63,24,122,119,118,24,24,208,63,28,28,2,24,4,4,4,4,3,2,2,2,2,3,3,1,2023-12-21 21:46:00,0
5166,5167,5167,5167,2017,24,208,24,147,2017,61,24,122,119,118,24,24,208,61,30,30,4,24,5,4,4,4,4,2,2,2,2,3,3,0,2023-12-21 21:48:00,3
5203,5202,5202,5202,2026,22,288,22,149,2026,139,22,122,119,119,22,22,288,88,32,32,0,22,8,8,7,7,6,0,2,2,2,3,3,1,2023-12-21 21:50:00,52
5182,5183,5183,5183,2027,24,198,24,145,2027,53,24,123,121,119,24,24,198,53,28,28,0,24,4,4,4,4,4,4,2,2,2,2,2,0,2023-12-21 21:52:00,0
5178,5176,5176,5176,2024,24,201,24,145,2024,56,24,125,123,118,24,24,201,56,28,28,0,24,4,4,4,4,4,10,2,2,2,2,2,0,2023-12-21 21:54:00,0
5188,5188,5188,5188,2022,24,217,24,144,2022,73,24,124,121,118,24,24,217,73,27,27,0,24,3,3,3,3,3,6,2,2,2,3,3,0,2023-12-21 21:56:00,0
5174,5174,5174,5174,2021,24,211,24,149,2021,62,24,123,120,118,24,24,211,62,32,32,0,24,8,8,8,8,8,4,2,2,2,3,3,0,2023-12-21 21:58:00,0
5221,5223,5223,5223,2042,24,208,24,145,2042,63,24,124,121,119,24,24,208,63,27,27,0,24,3,3,3,3,3,4,2,2,2,3,3,0,2023-12-21 22:00:00,0
5180,5180,5180,5180,2013,24,229,24,145,2013,84,24,123,122,118,24,24,229,84,28,28,5,24,4,4,4,4,3,8,2,2,2,1,1,1,2023-12-21 22:02:00,0
5195,5194,5194,5194,2022,24,221,24,148,2022,73,24,133,123,119,24,24,221,73,31,31,0,24,7,7,7,7,7,8,2,2,2,10,10,0,2023-12-21 22:04:00,0
5168,5169,5169,5169,2019,24,202,24,145,2019,57,24,122,119,118,24,24,202,57,28,28,0,24,4,4,4,4,3,2,2,2,2,3,3,1,2023-12-21 22:06:00,0
5182,5181,5181,5181,2022,24,217,24,145,2022,72,24,127,122,118,24,24,217,72,28,28,0,24,4,4,4,4,4,8,2,2,2,5,5,0,2023-12-21 22:08:00,0
5203,5204,5204,5204,2036,24,207,24,145,2036,62,24,123,119,118,24,24,207,62,28,28,0,24,4,4,4,4,4,2,2,2,2,4,4,0,2023-12-21 22:10:00,0
5160,5160,5160,5160,2019,24,198,24,148,2019,50,24,125,121,119,24,24,198,50,31,31,0,24,7,7,7,7,7,4,2,2,2,4,4,0,2023-12-21 22:12:00,0
5166,5164,5164,5164,2022,24,200,24,145,2022,55,24,122,122,118,24,24,200,55,28,28,0,24,4,4,4,4,4,8,2,2,2,0,0,0,2023-12-21 22:14:00,0
5169,5171,5171,5171,2023,22,192,22,145,2023,47,22,127,122,119,22,22,192,47,28,28,0,22,4,4,4,4,3,6,2,2,2,5,5,1,2023-12-21 22:16:00,0
5182,5182,5182,5182,2027,24,207,24,148,2027,59,24,122,120,118,24,24,207,59,31,31,0,24,7,7,7,7,7,4,2,2,2,2,2,0,2023-12-21 22:18:00,0
5204,5204,5204,5204,2028,24,220,24,144,2028,76,24,125,120,119,24,24,220,76,27,27,0,24,3,3,3,3,3,2,2,2,2,5,5,0,2023-12-21 22:20:00,0
5163,5162,5162,5162,2009,24,216,24,145,2009,71,24,125,121,118,24,24,216,71,28,28,0,24,4,4,4,4,3,6,2,2,2,4,4,1,2023-12-21 22:22:00,0
5183,5184,5184,5184,2028,24,203,24,145,2028,58,24,123,120,118,24,24,203,58,28,28,0,24,4,4,4,4,4,4,2,2,2,3,3,0,2023-12-21 22:24:00,0
5206,5224,5205,5205,2032,24,221,24,148,2032,73,24,123,121,119,24,24,221,73,31,31,0,24,7,7,7,7,7,4,2,2,2,2,2,0,2023-12-21 22:26:00,0
5200,5201,5201,5201,2036,24,206,24,146,2036,60,24,124,121,118,24,24,206,60,28,28,0,24,4,4,4,4,4,6,2,2,2,3,3,0,2023-12-21 22:28:00,0
5164,5164,5163,5163,2014,24,215,24,144,2014,71,24,128,121,118,24,24,215,71,28,28,0,24,4,4,4,4,4,6,2,2,2,7,7,0,2023-12-21 22:30:00,0
5182,5181,5181,5181,2029,24,201,24,145,2029,56,24,121,120,119,24,24,201,56,28,28,0,24,4,4,4,4,3,2,2,2,2,1,1,1,2023-12-21 22:32:00,0
5176,5179,5178,5178,2026,24,206,24,148,2026,58,24,122,120,118,24,24,206,58,31,31,0,24,7,7,7,7,7,4,2,2,2,2,2,0,2023-12-21 22:34:00,0
5188,5188,5188,5188,2027,24,203,24,145,2027,58,24,126,120,118,24,24,203,58,27,27,0,24,3,3,3,3,3,4,2,2,2,6,6,0,2023-12-21 22:36:00,0
5160,5159,5159,5159,2015,24,208,24,144,2015,64,24,121,120,118,24,24,208,64,28,28,0,24,4,4,4,4,3,4,2,2,2,1,1,1,2023-12-21 22:38:00,0
5170,5170,5170,5170,2026,24,197,24,149,2026,48,24,126,120,118,24,24,197,48,32,32,0,24,8,8,8,8,8,4,2,2,2,6,6,0,2023-12-21 22:40:00,0
5183,5184,5184,5184,2022,22,208,22,144,2022,64,22,131,120,118,22,22,208,64,27,27,0,22,3,3,3,3,3,4,2,2,2,11,11,0,2023-12-21 22:42:00,0
5185,5184,5184,5184,2031,24,201,24,146,2031,55,24,121,119,119,24,24,201,55,28,28,0,24,4,4,4,4,4,0,2,2,2,2,2,0,2023-12-21 22:44:00,0
5172,5173,5173,5173,2028,24,192,24,145,2028,47,24,123,120,119,24,24,192,47,28,28,0,24,4,4,4,4,4,2,2,2,2,3,3,0,2023-12-21 22:46:00,0
5191,5189,5189,5189,2026,24,215,24,148,2026,67,24,125,120,119,24,24,215,67,31,31,0,24,7,7,7,7,6,2,2,2,2,5,5,1,2023-12-21 22:48:00,0
5171,5173,5173,5173,2018,24,253,24,146,2018,107,24,129,122,119,24,24,253,56,29,29,0,24,5,5,4,4,4,6,2,2,2,7,7,0,2023-12-21 22:50:00,52
5200,5199,5199,5199,2039,24,202,24,148,2039,54,24,127,122,119,24,24,202,54,30,30,0,24,5,4,4,4,3,6,2,2,2,5,5,1,2023-12-21 22:52:00,3
5173,5173,5173,5173,2017,24,217,24,147,2017,70,24,121,120,118,24,24,217,70,31,31,0,24,7,7,7,7,7,4,2,2,2,1,1,0,2023-12-21 22:54:00,0
5137,5139,5138,5138,2004,24,212,24,144,2004,68,24,121,119,117,24,24,212,68,28,28,0,24,4,4,4,4,4,4,2,2,2,2,2,0,2023-12-21 22:56:00,0
5162,5162,5162,5162,2021,24,193,24,144,2021,49,24,125,120,118,24,24,193,49,27,27,0,24,3,3,3,3,3,4,2,2,2,5,5,0,2023-12-21 22:58:00,0
5186,5185,5185,5185,2028,24,206,24,145,2028,61,24,121,120,119,24,24,206,61,28,28,0,24,4,4,4,4,4,2,2,2,2,1,1,0,2023-12-21 23:00:00,0
5153,5154,5154,5154,2009,24,211,24,148,2009,63,24,123,120,118,24,24,211,63,31,31,0,24,7,7,7,7,7,4,2,2,2,3,3,0,2023-12-21 23:02:00,0
5181,5181,5181,5181,2017,24,225,24,145,2017,80,24,123,120,118,24,24,225,80,28,28,0,24,4,4,4,4,3,4,2,2,2,3,3,1,2023-12-21 23:04:00,0
5185,5184,5184,5184,2022,24,212,24,145,2022,67,24,124,118,118,24,24,212,67,28,28,0,24,4,4,4,4,4,0,2,2,2,6,6,0,2023-12-21 23:06:00,0
5160,5160,5160,5160,2025,22,192,22,145,2025,47,22,122,118,118,22,22,192,47,28,28,0,22,4,4,4,4,3,0,2,2,2,4,4,1,2023-12-21 23:08:00,0
5149,5149,5149,5149,2013,24,198,24,147,2013,51,24,121,120,118,24,24,198,51,31,31,0,24,7,7,7,7,7,4,2,2,2,1,1,0,2023-12-21 23:10:00,0
5182,5183,5183,5183,2019,24,219,24,145,2019,74,24,123,122,118,24,24,219,74,28,28,0,24,4,4,4,4,4,8,2,2,2,1,1,0,2023-12-21 23:12:00,0
5193,5193,5193,5193,2033,24,202,24,144,2033,58,24,124,119,118,24,24,202,58,27,27,0,24,3,3,3,3,3,2,2,2,2,5,5,0,2023-12-21 23:14:00,0
5153,5152,5152,5152,2017,24,195,24,149,2017,46,24,123,118,118,24,24,195,46,32,32,0,24,8,8,8,8,8,0,2,2,2,5,5,0,2023-12-21 23:16:00,0
5131,5132,5132,5132,2003,24,200,24,142,2003,58,24,125,121,118,24,24,200,58,26,26,0,24,3,3,3,3,3,6,2,2,2,4,4,0,2023-12-21 23:18:00,0
5169,5188,5169,5169,2025,24,198,24,145,2025,53,24,123,120,118,24,24,198,53,28,28,0,24,4,4,4,4,3,4,2,2,2,3,3,1,2023-12-21 23:20:00,0
5187,5187,5187,5187,2022,24,216,24,145,2022,71,24,124,120,119,24,24,216,71,28,28,0,24,4,4,4,4,4,2,2,2,2,4,4,0,2023-12-21 23:22:00,0
5194,5193,5193,5193,2027,24,218,24,148,2027,70,24,122,118,118,24,24,218,70,31,31,0,24,7,7,7,7,6,0,2,2,2,4,4,1,2023-12-21 23:24:00,0
5207,5208,5208,5208,2038,24,207,24,146,2038,61,24,124,120,119,24,24,207,61,28,28,0,24,4,4,4,4,4,2,2,2,2,4,4,0,2023-12-21 23:26:00,0
5200,5200,5200,5200,2032,24,211,24,146,2032,65,24,123,120,118,24,24,211,65,28,28,0,24,4,4,4,4,4,4,2,2,2,3,3,0,2023-12-21 23:28:00,0
5174,5172,5172,5172,2029,24,199,24,148,2029,51,24,121,118,118,24,24,199,51,31,31,0,24,7,7,7,7,7,0,2,2,2,3,3,0,2023-12-21 23:30:00,0
5203,5203,5203,5203,2031,24,216,24,145,2031,71,24,124,122,120,24,24,216,71,28,28,0,24,4,4,4,4,4,4,2,2,2,2,2,0,2023-12-21 23:32:00,0
5179,5180,5180,5180,2026,22,200,22,144,2026,56,22,124,121,119,22,22,200,56,27,27,0,22,3,3,3,3,3,4,2,2,2,3,3,0,2023-12-21 23:34:00,0
5176,5195,5176,5176,2024,24,204,24,145,2024,59,24,121,118,118,24,24,204,59,28,28,0,24,4,4,4,4,3,0,2,2,2,3,3,1,2023-12-21 23:36:00,0
5173,5174,5174,5174,2027,24,200,24,149,2027,51,24,121,119,118,24,24,200,51,32,32,0,24,7,7,7,7,7,2,2,2,2,2,2,0,2023-12-21 23:38:00,0
5183,5182,5182,5182,2033,24,189,24,146,2033,43,24,124,120,120,24,24,189,43,28,28,0,24,4,4,4,4,3,0,2,2,2,4,4,1,2023-12-21 23:40:00,0
5106,5107,5107,5107,1993,24,200,24,143,1993,57,24,120,117,117,24,24,200,57,27,27,0,24,4,4,4,4,4,0,2,2,2,3,3,0,2023-12-21 23:42:00,0
5187,5185,5185,5185,2020,24,219,24,144,2020,75,24,122,120,118,24,24,219,75,28,28,0,24,4,4,4,4,4,4,2,2,2,2,2,0,2023-12-21 23:44:00,0
5184,5185,5185,5185,2017,24,219,24,148,2017,71,24,129,123,119,24,24,219,71,31,31,0,24,7,7,7,7,7,8,2,2,2,6,6,0,2023-12-21 23:46:00,0
5182,5182,5182,5182,2033,24,196,24,146,2033,50,24,118,118,118,24,24,196,50,28,28,0,24,4,4,4,4,4,0,2,2,2,0,0,0,2023-12-21 23:48:00,0
5179,5180,5180,5180,2024,24,254,24,146,2024,108,24,125,120,119,24,24,254,57,29,29,0,24,5,5,4,4,3,2,2,2,2,5,5,1,2023-12-21 23:50:00,52
5189,5187,5187,5187,2025,24,218,24,148,2025,70,24,123,119,119,24,24,218,70,31,31,0,24,7,7,7,7,7,0,2,2,2,4,4,0,2023-12-21 23:52:00,0
5165,5167,5167,5167,2023,24,196,24,144,2023,52,24,124,120,118,24,24,196,52,27,27,0,24,3,3,3,3,3,4,2,2,2,4,4,0,2023-12-21 23:54:00,0
5209,5209,5208,5208,2037,24,212,24,145,2037,67,24,122,118,118,24,24,212,67,28,28,0,24,4,4,4,4,3,0,2,2,2,4,4,1,2023-12-21 23:56:00,0
5182,5202,5183,5183,2021,24,212,24,145,2021,67,24,125,123,120,24,24,212,67,28,28,0,24,4,4,4,4,4,6,2,2,2,2,2,0,2023-12-21 23:58:00,0
5160,5160,5160,5160,2016,22,209,22,147,2016,62,22,121,119,118,22,22,209,62,31,31,0,22,7,7,7,7,7,2,2,2,2,2,2,0,2023-12-22 00:00:00,0
5178,5178,5178,5178,2016,24,214,24,146,2016,68,24,123,118,118,24,24,214,68,28,28,0,24,4,4,4,4,4,0,2,2,2,5,5,0,2023-12-22 00:02:00,0
5164,5164,5164,5164,2021,24,198,24,144,2021,54,24,123,121,118,24,24,198,54,28,28,0,24,4,4,4,4,4,6,2,2,2,2,2,0,2023-12-22 00:04:00,0
5159,5158,5158,5158,2021,24,209,24,148,2021,61,24,122,119,118,24,24,209,61,31,31,0,24,7,7,7,7,6,2,2,2,2,3,3,1,2023-12-22 00:06:00,0
5206,5206,5206,5206,2023,24,233,24,145,2023,88,24,127,121,119,24,24,233,88,28,28,0,24,4,4,4,4,4,4,2,2,2,6,6,0,2023-12-22 00:08:00,0
5163,5164,5164,5164,2016,24,203,24,143,2016,60,24,126,119,118,24,24,203,60,27,27,0,24,3,3,3,3,3,2,2,2,2,7,7,0,2023-12-22 00:10:00,0
5162,5161,5161,5161,2019,24,205,24,145,2019,60,24,122,119,118,24,24,205,60,28,28,0,24,4,4,4,4,3,2,2,2,2,3,3,1,2023-12-22 00:12:00,0
5157,5158,5158,5158,2025,24,202,24,149,2025,53,24,121,120,119,24,24,202,53,32,32,0,24,8,8,8,8,8,2,2,2,2,1,1,0,2023-12-22 00:14:00,0
5178,5178,5178,5178,2030,24,199,24,144,2030,55,24,122,121,119,24,24,199,55,27,27,0,24,3,3,3,3,3,4,2,2,2,1,1,0,2023-12-22 00:16:00,0
5208,5227,5208,5208,2038,24,206,24,146,2038,60,24,124,120,119,24,24,206,60,28,28,0,24,4,4,4,4,4,2,2,2,2,4,4,0,2023-12-22 00:18:00,0
5172,5191,5172,5172,2021,24,206,24,145,2021,61,24,125,120,118,24,24,206,61,28,28,4,24,4,4,4,4,4,4,2,2,2,5,5,0,2023-12-22 00:20:00,0
5167,5166,5166,5166,2011,24,218,24,147,2011,71,24,127,126,119,24,24,218,71,31,31,5,24,7,7,7,7,6,14,2,2,2,1,1,1,2023-12-22 00:22:00,0
5178,5179,5179,5179,2019,24,210,24,145,2019,65,24,129,121,118,24,24,210,65,28,28,0,24,4,4,4,4,4,6,2,2,2,8,8,0,2023-12-22 00:24:00,0
5184,5183,5183,5183,2036,22,196,22,146,2036,50,22,121,119,118,22,22,196,50,28,28,0,22,4,4,4,4,3,2,2,2,2,2,2,1,2023-12-22 00:26:00,0
5120,5120,5120,5120,1997,24,213,24,146,1997,67,24,120,118,117,24,24,213,67,31,31,0,24,7,7,7,7,7,2,2,2,2,2,2,0,2023-12-22 00:28:00,0
5178,5178,5178,5178,2016,24,216,24,145,2016,71,24,127,120,119,24,24,216,71,28,28,0,24,4,4,4,4,4,2,2,2,2,7,7,0,2023-12-22 00:30:00,0
5178,5179,5179,5179,2028,24,202,24,144,2028,58,24,122,119,118,24,24,202,58,27,27,0,24,3,3,3,3,3,2,2,2,2,3,3,0,2023-12-22 00:32:00,0
5204,5202,5202,5202,2034,24,212,24,146,2034,66,24,123,119,119,24,24,212,66,28,28,0,24,4,4,4,4,4,0,2,2,2,4,4,0,2023-12-22 00:34:00,0
5183,5184,5184,5184,2028,24,202,24,148,2028,54,24,126,120,118,24,24,202,54,31,31,0,24,7,7,7,7,7,4,2,2,2,6,6,0,2023-12-22 00:36:00,0
5167,5168,5168,5168,2023,24,198,24,145,2023,53,24,121,119,118,24,24,198,53,28,28,0,24,4,4,4,4,3,2,2,2,2,2,2,1,2023-12-22 00:38:00,0
5163,5162,5162,5162,2027,24,189,24,145,2027,44,24,119,118,118,24,24,189,44,28,28,5,24,4,4,4,4,4,0,2,2,2,1,1,0,2023-12-22 00:40:00,0
5133,5134,5134,5134,2014,24,189,24,148,2014,41,24,122,120,118,24,24,189,41,31,31,0,24,7,7,7,7,6,4,2,2,2,2,2,1,2023-12-22 00:42:00,0
5195,5194,5194,5194,2030,24,204,24,145,2030,59,24,127,120,119,24,24,204,59,28,28,0,24,4,4,4,4,4,2,2,2,2,7,7,0,2023-12-22 00:44:00,0
5207,5208,5208,5208,2039,24,207,24,146,2039,61,24,124,120,118,24,24,207,61,28,28,0,24,4,4,4,4,4,4,2,2,2,4,4,0,2023-12-22 00:46:00,0
5205,5205,5205,5205,2034,24,215,24,145,2034,70,24,121,120,119,24,24,215,70,27,27,0,24,3,3,3,3,3,2,2,2,2,1,1,0,2023-12-22 00:48:00,0
5196,5196,5196,5196,2030,24,269,24,150,2030,119,24,126,119,118,24,24,269,68,33,33,0,24,9,9,8,8,8,2,2,2,2,7,7,0,2023-12-22 00:50:00,52
5118,5118,5118,5118,2007,22,189,22,143,2007,46,22,121,118,117,22,22,189,46,27,27,0,22,3,3,3,3,3,2,2,2,2,3,3,0,2023-12-22 00:52:00,0
5181,5181,5181,5181,2028,24,203,24,145,2028,58,24,124,122,118,24,24,203,58,28,28,0,24,4,4,4,4,3,8,2,2,2,2,2,1,2023-12-22 00:54:00,0
5178,5178,5178,5178,2025,24,205,24,145,2025,60,24,122,121,119,24,24,205,60,28,28,0,24,4,4,4,4,4,4,2,2,2,1,1,0,2023-12-22 00:56:00,0
5170,5189,5169,5169,2023,24,206,24,148,2023,58,24,121,120,119,24,24,206,58,31,31,0,24,7,7,7,7,6,2,2,2,2,1,1,1,2023-12-22 00:58:00,0
5177,5178,5178,5178,2030,24,199,24,146,2030,53,24,122,121,118,24,24,199,53,28,28,0,24,4,4,4,4,4,6,2,2,2,1,1,0,2023-12-22 01:00:00,0
5198,5198,5198,5198,2021,24,324,24,145,2021,179,24,130,125,119,24,24,324,179,28,28,1,24,4,4,4,4,4,12,2,2,2,5,5,0,2023-12-22 01:02:00,0
5179,5178,5178,5178,2020,24,223,24,148,2020,75,24,120,119,117,24,24,223,75,31,31,9,24,7,7,7,7,7,4,2,2,2,1,1,0,2023-12-22 01:04:00,0
5165,5165,5165,5165,2012,24,216,24,144,2012,72,24,124,122,118,24,24,216,72,28,28,4,24,4,4,4,4,4,8,2,2,2,2,2,0,2023-12-22 01:06:00,0
5203,5204,5204,5204,2026,24,233,24,146,2026,87,24,125,122,119,24,24,233,87,29,29,2,24,4,3,3,3,3,6,2,2,2,3,3,0,2023-12-22 01:08:00,3
5209,5209,5209,5209,2035,24,217,24,146,2035,71,24,125,122,118,24,24,217,71,28,28,4,24,4,4,4,4,3,8,2,2,2,3,3,1,2023-12-22 01:10:00,0
5147,5165,5146,5146,2001,24,227,24,147,2001,80,24,124,122,118,24,24,227,80,31,31,0,24,7,7,7,7,7,8,2,2,2,2,2,0,2023-12-22 01:12:00,0
5196,5197,5197,5197,2027,24,218,24,145,2027,73,24,123,119,118,24,24,218,73,28,28,0,24,4,4,4,4,3,2,2,2,2,4,4,1,2023-12-22 01:14:00,0
5171,5170,5170,5170,2022,23,204,23,145,2022,59,23,123,119,118,23,23,204,59,28,28,0,23,4,4,4,4,4,2,2,2,2,4,4,0,2023-12-22 01:16:00,0
5173,5173,5173,5173,2024,23,206,23,145,2024,61,23,120,119,119,23,23,206,61,28,28,0,23,4,4,4,4,4,0,2,2,2,1,1,0,2023-12-22 01:18:00,0
5208,5208,5208,5208,2032,24,220,24,149,2032,71,24,129,122,118,24,24,220,71,31,31,0,24,7,7,7,7,7,8,2,2,2,7,7,0,2023-12-22 01:20:00,0
5141,5142,5142,5142,2008,24,211,24,144,2008,67,24,121,119,118,24,24,211,67,28,28,0,24,4,4,4,4,4,2,2,2,2,2,2,0,2023-12-22 01:22:00,0
5211,5230,5211,5211,2035,24,221,24,149,2035,72,24,123,118,118,24,24,221,72,31,31,0,24,4,4,4,4,3,0,2,2,2,5,5,1,2023-12-22 01:24:00,6
5180,5199,5180,5180,2024,24,211,24,148,2024,63,24,125,121,118,24,24,211,63,31,31,0,24,7,7,7,7,7,6,2,2,2,4,4,0,2023-12-22 01:26:00,0
5205,5205,5205,5205,2035,24,209,24,144,2035,65,24,125,120,119,24,24,209,65,27,27,0,24,3,3,3,3,3,2,2,2,2,5,5,0,2023-12-22 01:28:00,0
5200,5200,5200,5200,2028,24,214,24,145,2028,69,24,127,122,119,24,24,214,69,28,28,0,24,4,4,4,4,3,6,2,2,2,5,5,1,2023-12-22 01:30:00,0
5208,5208,5208,5208,2030,24,222,24,146,2030,76,24,127,122,119,24,24,222,76,28,28,0,24,4,4,4,4,4,6,2,2,2,5,5,0,2023-12-22 01:32:00,0
5194,5194,5194,5194,2022,24,230,24,147,2022,83,24,122,118,118,24,24,230,83,31,31,0,24,7,7,7,7,7,0,2,2,2,4,4,0,2023-12-22 01:34:00,0
5158,5176,5157,5157,2009,24,230,24,144,2009,86,24,122,119,117,24,24,230,86,28,28,0,24,4,4,4,4,4,4,2,2,2,3,3,0,2023-12-22 01:36:00,0
5197,5197,5197,5197,2035,24,204,24,146,2035,58,24,128,121,119,24,24,204,58,28,28,0,24,4,4,4,4,4,4,2,2,2,7,7,0,2023-12-22 01:38:00,0
5176,5177,5177,5177,2023,24,206,24,145,2023,61,24,124,121,119,24,24,206,61,28,28,0,24,4,4,4,4,3,4,2,2,2,3,3,1,2023-12-22 01:40:00,0
5155,5155,5154,5154,2011,24,210,24,148,2011,62,24,123,120,117,24,24,210,62,31,31,0,24,7,7,7,7,7,6,2,2,2,3,3,0,2023-12-22 01:42:00,0
5195,5196,5196,5196,2032,22,214,22,144,2032,70,22,122,119,119,22,22,214,70,27,27,0,22,3,3,3,3,3,0,2,2,2,3,3,0,2023-12-22 01:44:00,0
5166,5166,5166,5166,2014,24,213,24,145,2014,68,24,125,121,119,24,24,213,68,28,28,0,24,4,4,4,4,3,4,2,2,2,4,4,1,2023-12-22 01:46:00,0
5182,5182,5182,5182,2028,24,210,24,149,2028,61,24,122,119,118,24,24,210,61,32,32,0,24,8,8,8,8,8,2,2,2,2,3,3,0,2023-12-22 01:48:00,0
5191,5191,5191,5191,2017,24,281,24,144,2017,137,24,127,121,119,24,24,281,86,28,28,0,24,4,4,3,3,3,4,2,2,2,6,6,0,2023-12-22 01:50:00,52
5181,5181,5181,5181,2024,24,206,24,145,2024,61,24,126,121,118,24,24,206,61,28,28,0,24,4,4,4,4,4,6,2,2,2,5,5,0,2023-12-22 01:52:00,0
5182,5182,5182,5182,2027,24,207,24,145,2027,62,24,121,120,118,24,24,207,62,28,28,0,24,4,4,4,4,4,4,2,2,2,1,1,0,2023-12-22 01:54:00,0
5173,5193,5173,5173,2017,24,217,24,148,2017,69,24,123,119,119,24,24,217,69,31,31,0,24,7,7,7,7,6,0,2,2,2,4,4,1,2023-12-22 01:56:00,0
5192,5192,5192,5192,2026,24,215,24,145,2026,70,24,123,120,118,24,24,215,70,28,28,0,24,4,4,4,4,4,4,2,2,2,3,3,0,2023-12-22 01:58:00,0
5143,5143,5143,5143,2007,24,212,24,143,2007,69,24,123,118,117,24,24,212,69,27,27,0,24,4,4,4,4,3,2,2,2,2,5,5,1,2023-12-22 02:00:00,0
5189,5189,5189,5189,2017,24,229,24,148,2017,81,24,127,123,119,24,24,229,81,31,31,5,24,7,7,7,7,7,8,2,2,2,4,4,0,2023-12-22 02:02:00,0
5182,5182,5182,5182,2026,24,208,24,146,2026,62,24,125,120,118,24,24,208,62,29,29,0,24,4,4,4,4,4,4,2,2,2,5,5,0,2023-12-22 02:04:00,0
5213,5212,5212,5212,2032,24,223,24,145,2032,78,24,124,121,119,24,24,223,78,27,27,0,24,3,3,3,3,3,4,2,2,2,3,3,0,2023-12-22 02:06:00,0
5165,5166,5166,5166,2016,24,207,24,144,2016,63,24,123,120,118,24,24,207,63,28,28,0,24,4,4,4,4,4,4,2,2,2,3,3,0,2023-12-22 02:08:00,0
5190,5190,5190,5190,2029,22,216,22,149,2029,67,22,119,118,118,22,22,216,67,31,31,0,22,7,7,7,7,7,0,2,2,2,1,1,0,2023-12-22 02:10:00,0
5215,5215,5215,5215,2036,24,215,24,146,2036,69,24,126,123,121,24,24,215,69,29,29,0,24,4,4,4,4,3,4,2,2,2,3,3,1,2023-12-22 02:12:00,2
5187,5187,5187,5187,2028,24,204,24,146,2028,58,24,125,119,118,24,24,204,58,28,28,0,24,4,4,4,4,4,2,2,2,2,6,6,0,2023-12-22 02:14:00,0
5183,5182,5182,5182,2023,24,212,24,144,2023,68,24,122,120,118,24,24,212,68,28,28,0,24,4,4,4,4,3,4,2,2,2,2,2,1,2023-12-22 02:16:00,0
5160,5161,5161,5161,2025,24,191,24,149,2025,42,24,125,122,119,24,24,191,42,31,31,0,24,7,7,7,7,7,6,2,2,2,3,3,0,2023-12-22 02:18:00,0
5182,5182,5182,5182,2031,24,195,24,145,2031,50,24,121,118,118,24,24,195,50,28,28,0,24,4,4,4,4,4,0,2,2,2,3,3,0,2023-12-22 02:20:00,0
5154,5154,5154,5154,2010,24,218,24,144,2010,74,24,119,118,117,24,24,218,74,27,27,0,24,3,3,3,3,3,2,2,2,2,1,1,0,2023-12-22 02:22:00,2
5176,5176,5176,5176,2019,24,222,24,150,2019,72,24,120,118,118,24,24,222,72,34,34,0,24,8,8,8,8,8,0,2,2,2,2,2,0,2023-12-22 02:24:00,4
5167,5166,5166,5166,2023,24,194,24,144,2023,50,24,124,121,118,24,24,194,50,27,27,0,24,3,3,3,3,3,6,2,2,2,3,3,0,2023-12-22 02:26:00,0
5172,5173,5173,5173,2026,24,196,24,145,2026,51,24,124,121,119,24,24,196,51,28,28,0,24,4,4,4,4,3,4,2,2,2,3,3,1,2023-12-22 02:28:00,0
5200,5199,5199,5199,2035,24,204,24,146,2035,58,24,126,122,118,24,24,204,58,28,28,0,24,4,4,4,4,4,8,2,2,2,4,4,0,2023-12-22 02:30:00,0
5161,5162,5162,5162,2012,24,210,24,147,2012,63,24,126,123,118,24,24,210,63,31,31,0,24,7,7,7,7,6,10,2,2,2,3,3,1,2023-12-22 02:32:00,0
5178,5177,5177,5177,2024,24,204,24,145,2024,59,24,124,120,119,24,24,204,59,28,28,0,24,4,4,4,4,4,2,2,2,2,4,4,0,2023-12-22 02:34:00,0
5177,5177,5177,5177,2018,22,218,22,145,2018,73,22,120,119,118,22,22,218,73,28,28,0,22,4,4,4,4,4,2,2,2,2,1,1,0,2023-12-22 02:36:00,0
5171,5171,5171,5171,2022,24,207,24,148,2022,59,24,122,119,118,24,24,207,59,31,31,0,24,7,7,7,7,7,2,2,2,2,3,3,0,2023-12-22 02:38:00,0
5158,5159,5159,5159,2015,24,201,24,144,2015,57,24,125,121,119,24,24,201,57,28,28,0,24,4,4,4,4,4,4,2,2,2,4,4,0,2023-12-22 02:40:00,0
5150,5150,5150,5150,2017,24,195,24,144,2017,51,24,119,118,118,24,24,195,51,27,27,0,24,3,3,3,3,3,0,2,2,2,1,1,0,2023-12-22 02:42:00,0
5143,5142,5142,5142,2011,24,189,24,144,2011,45,24,124,118,118,24,24,189,45,28,28,0,24,4,4,4,4,3,0,2,2,2,6,6,1,2023-12-22 02:44:00,0
5093,5093,5093,5093,1994,24,192,24,146,1994,46,24,120,116,116,24,24,192,46,31,31,0,24,7,7,7,7,7,0,2,2,2,4,4,0,2023-12-22 02:46:00,0
5190,5191,5190,5190,2028,24,209,24,145,2028,64,24,124,120,119,24,24,209,64,28,28,0,24,4,4,4,4,3,2,2,2,2,4,4,1,2023-12-22 02:48:00,0
5185,5186,5186,5186,2030,24,254,24,147,2030,107,24,120,118,118,24,24,254,56,29,29,0,24,5,5,4,4,4,0,2,2,2,2,2,0,2023-12-22 02:50:00,52
5182,5182,5182,5182,2025,24,214,24,148,2025,66,24,122,120,118,24,24,214,66,31,31,0,24,7,7,7,7,7,4,2,2,2,2,2,0,2023-12-22 02:52:00,0
5188,5186,5186,5186,2029,24,204,24,145,2029,59,24,123,119,118,24,24,204,59,28,28,0,24,4,4,4,4,4,2,2,2,2,4,4,0,2023-12-22 02:54:00,0
5176,5177,5177,5177,2033,24,191,24,146,2033,45,24,120,120,119,24,24,191,45,28,28,0,24,4,4,4,4,4,2,2,2,2,0,0,0,2023-12-22 02:56:00,0
5189,5190,5190,5190,2028,24,210,24,145,2028,65,24,121,119,118,24,24,210,65,28,28,0,24,4,4,4,4,3,2,2,2,2,2,2,1,2023-12-22 02:58:00,0
5210,5209,5209,5209,2032,24,225,24,148,2032,77,24,121,119,118,24,24,225,77,31,31,0,24,7,7,7,7,7,2,2,2,2,2,2,0,2023-12-22 03:00:00,0
5162,5163,5163,5163,2003,22,328,22,144,2003,184,22,127,123,119,22,22,328,184,27,27,0,22,3,3,3,3,3,8,2,2,2,4,4,0,2023-12-22 03:02:00,0
5171,5170,5170,5170,2025,24,200,24,145,2025,55,24,120,118,118,24,24,200,55,28,28,0,24,4,4,4,4,3,0,2,2,2,2,2,1,2023-12-22 03:04:00,0
5208,5229,5209,5209,2034,24,216,24,145,2034,71,24,125,120,119,24,24,216,71,28,28,0,24,4,4,4,4,4,2,2,2,2,5,5,0,2023-12-22 03:06:00,0
5169,5169,5169,5169,2019,24,225,24,148,2019,77,24,118,117,117,24,24,225,77,31,31,0,24,7,7,7,7,7,0,2,2,2,1,1,0,2023-12-22 03:08:00,0
5179,5179,5179,5179,2026,24,205,24,145,2026,60,24,120,119,119,24,24,205,60,28,28,0,24,4,4,4,4,4,0,2,2,2,1,1,0,2023-12-22 03:10:00,0
5180,5180,5180,5180,2031,24,207,24,161,2031,46,24,124,121,118,24,24,207,46,44,44,0,24,12,4,4,4,4,6,2,2,2,3,3,0,2023-12-22 03:12:00,69
5201,5201,5201,5201,2031,24,219,24,149,2031,70,24,124,120,119,24,24,219,70,31,31,0,24,7,7,7,7,6,2,2,2,2,4,4,1,2023-12-22 03:14:00,0
5222,5222,5222,5222,2032,24,228,24,145,2032,83,24,127,119,119,24,24,228,83,28,28,0,24,4,4,4,4,4,0,2,2,2,8,8,0,2023-12-22 03:16:00,0
5204,5223,5203,5203,2037,24,205,24,145,2037,60,24,123,119,118,24,24,205,60,27,27,0,24,3,3,3,3,3,2,2,2,2,4,4,0,2023-12-22 03:18:00,0
5191,5192,5192,5192,2028,24,211,24,145,2028,66,24,124,120,119,24,24,211,66,28,28,0,24,4,4,4,4,3,2,2,2,2,4,4,1,2023-12-22 03:20:00,0
5181,5199,5180,5180,2024,24,213,24,149,2024,64,24,123,119,119,24,24,213,64,32,32,0,24,8,8,8,8,8,0,2,2,2,4,4,0,2023-12-22 03:22:00,0
5189,5190,5190,5190,2023,24,212,24,144,2023,68,24,128,122,118,24,24,212,68,27,27,0,24,3,3,3,3,3,8,2,2,2,6,6,0,2023-12-22 03:24:00,0
5194,5193,5193,5193,2024,24,217,24,145,2024,72,24,128,122,118,24,24,217,72,28,28,0,24,4,4,4,4,4,8,2,2,2,6,6,0,2023-12-22 03:26:00,0
5203,5201,5201,5201,2031,24,219,23,148,2031,71,23,125,120,118,23,23,219,71,31,31,0,23,7,7,7,7,7,4,2,2,2,5,5,0,2023-12-22 03:28:00,0
5147,5168,5149,5149,2016,22,197,23,145,2016,52,23,125,124,118,23,23,197,52,28,28,0,23,4,4,4,4,3,12,2,2,2,1,1,1,2023-12-22 03:30:00,0
7514,7513,7513,7513,2937,34,303,34,211,2937,92,34,180,175,171,34,34,303,92,41,41,0,34,7,7,7,7,7,8,3,3,3,5,5,0,2023-12-22 03:32:00,0
5166,5184,5165,5165,2021,24,197,24,145,2021,52,24,123,121,118,24,24,197,52,28,28,0,24,4,4,4,4,3,6,2,2,2,2,2,1,2023-12-22 03:34:00,0
5176,5177,5177,5177,2027,24,201,24,149,2027,52,24,126,121,118,24,24,201,52,32,32,0,24,7,7,7,7,7,6,2,2,2,5,5,0,2023-12-22 03:36:00,2
5184,5185,5185,5185,2026,24,206,24,145,2026,61,24,122,118,118,24,24,206,61,28,28,0,24,4,4,4,4,4,0,2,2,2,4,4,0,2023-12-22 03:38:00,0
5175,5175,5175,5175,2025,24,202,24,144,2025,58,24,122,119,119,24,24,202,58,27,27,0,24,3,3,3,3,3,0,2,2,2,3,3,0,2023-12-22 03:40:00,0
5156,5156,5156,5156,2020,24,189,24,145,2020,44,24,121,119,118,24,24,189,44,28,28,0,24,4,4,4,4,4,2,2,2,2,2,2,0,2023-12-22 03:42:00,0
5176,5175,5175,5175,2028,24,198,24,148,2028,50,24,121,120,118,24,24,198,50,31,31,0,24,7,7,7,7,7,4,2,2,2,1,1,0,2023-12-22 03:44:00,0
5158,5156,5156,5156,2018,24,198,24,145,2018,53,24,122,118,118,24,24,198,53,28,28,0,24,4,4,4,4,3,0,2,2,2,4,4,1,2023-12-22 03:46:00,0
5179,5182,5182,5182,2023,24,212,24,145,2023,67,24,124,120,118,24,24,212,67,28,28,0,24,4,4,4,4,4,4,2,2,2,4,4,0,2023-12-22 03:48:00,0
5206,5226,5205,5205,2026,24,279,24,149,2026,130,24,130,121,119,24,24,279,79,32,32,0,24,8,8,7,7,6,4,2,2,2,9,9,1,2023-12-22 03:50:00,52
5158,5158,5158,5158,2015,23,210,23,144,2015,66,23,124,122,119,23,22,210,66,28,28,0,23,4,4,4,4,4,6,2,2,2,2,2,0,2023-12-22 03:52:00,0
5178,5179,5179,5179,2027,23,199,23,145,2027,54,23,127,121,118,23,24,199,54,28,28,0,23,4,4,4,4,4,6,2,2,2,6,6,0,2023-12-22 03:54:00,0
5201,5201,5201,5201,2033,24,208,24,145,2033,63,24,122,119,118,24,24,208,63,27,27,0,24,3,3,3,3,3,2,2,2,2,3,3,0,2023-12-22 03:56:00,0
5184,5184,5184,5184,2022,24,218,24,149,2022,69,24,121,120,120,24,24,218,69,32,32,0,24,8,8,8,8,8,0,2,2,2,1,1,0,2023-12-22 03:58:00,0
5166,5166,5166,5166,2013,24,209,24,143,2013,66,24,124,120,117,24,24,209,66,27,27,0,24,3,3,3,3,3,6,2,2,2,4,4,0,2023-12-22 04:00:00,0
5156,5154,5154,5154,2009,24,199,24,145,2009,54,24,130,123,118,24,24,199,54,28,28,0,24,4,4,4,4,3,10,2,2,2,7,7,1,2023-12-22 04:02:00,0
5172,5173,5173,5173,2014,24,218,24,144,2014,74,24,125,121,118,24,24,218,74,28,28,0,24,4,4,4,4,4,6,2,2,2,4,4,0,2023-12-22 04:04:00,0
5188,5188,5188,5188,2019,24,226,24,148,2019,78,24,121,119,119,24,24,226,78,31,31,0,24,7,7,7,7,6,0,2,2,2,2,2,1,2023-12-22 04:06:00,0
5181,5182,5182,5182,2022,24,210,24,145,2022,65,24,123,119,118,24,24,210,65,28,28,0,24,4,4,4,4,4,2,2,2,2,4,4,0,2023-12-22 04:08:00,0
5180,5180,5180,5180,2022,24,208,24,145,2022,63,24,124,121,118,24,24,208,63,28,28,0,24,4,4,4,4,4,6,2,2,2,3,3,0,2023-12-22 04:10:00,0
5213,5212,5212,5212,2034,24,223,24,148,2034,75,24,127,119,119,24,24,223,75,31,31,0,24,7,7,7,7,7,0,2,2,2,8,8,0,2023-12-22 04:12:00,0
5138,5139,5139,5139,1999,24,222,24,144,1999,78,24,124,119,117,24,24,222,78,28,28,0,24,4,4,4,4,4,4,2,2,2,5,5,0,2023-12-22 04:14:00,0
5195,5193,5193,5193,2031,24,204,24,144,2031,60,24,125,119,118,24,24,204,60,27,27,0,24,3,3,3,3,3,2,2,2,2,6,6,0,2023-12-22 04:16:00,0
5179,5180,5180,5180,2024,22,208,22,145,2024,63,22,122,119,118,22,22,208,63,28,28,0,22,4,4,4,4,3,2,2,2,2,3,3,1,2023-12-22 04:18:00,0
5181,5182,5182,5182,2028,24,201,24,149,2028,52,24,123,120,119,24,24,201,52,31,31,0,24,7,7,7,7,7,2,2,2,2,3,3,0,2023-12-22 04:20:00,0
5161,5161,5161,5161,2011,24,212,24,144,2011,68,24,123,121,118,24,24,212,68,28,28,0,24,4,4,4,4,3,6,2,2,2,2,2,1,2023-12-22 04:22:00,0
5203,5202,5202,5202,2038,24,206,24,147,2038,59,24,122,120,119,24,24,206,59,29,29,0,24,4,4,4,4,4,2,2,2,2,2,2,0,2023-12-22 04:24:00,2
5189,5189,5189,5189,2026,24,212,24,148,2026,64,24,126,122,118,24,24,212,64,31,31,0,24,7,7,7,7,7,8,2,2,2,4,4,0,2023-12-22 04:26:00,0
5180,5181,5181,5181,2025,24,208,24,145,2025,63,24,122,120,119,24,24,208,63,28,28,0,24,4,4,4,4,4,2,2,2,2,2,2,0,2023-12-22 04:28:00,0
5180,5200,5180,5180,2029,24,199,24,146,2029,53,24,123,120,119,24,24,199,53,28,28,0,24,4,4,4,4,4,2,2,2,2,3,3,0,2023-12-22 04:30:00,0
5172,5171,5171,5171,2015,24,212,24,144,2015,68,24,125,122,118,24,24,212,68,28,28,0,24,4,4,4,4,3,8,2,2,2,3,3,1,2023-12-22 04:32:00,0
5160,5161,5161,5161,2017,24,203,24,148,2017,55,24,126,119,117,24,24,203,55,31,31,0,24,7,7,7,7,7,4,2,2,2,7,7,0,2023-12-22 04:34:00,0
5208,5208,5208,5208,2028,24,220,24,144,2028,76,24,129,121,120,24,24,220,76,27,27,0,24,3,3,3,3,3,2,2,2,2,8,8,0,2023-12-22 04:36:00,0
5151,5170,5151,5151,2016,24,205,24,145,2016,60,24,119,117,117,24,24,205,60,28,28,0,24,4,4,4,4,3,0,2,2,2,2,2,1,2023-12-22 04:38:00,0
5182,5182,5182,5182,2027,24,205,24,145,2027,60,24,125,119,119,24,24,205,60,28,28,0,24,4,4,4,4,4,0,2,2,2,6,6,0,2023-12-22 04:40:00,0
5172,5173,5172,5172,2026,24,199,24,148,2026,51,24,122,120,118,24,24,199,51,31,31,0,24,7,7,7,7,7,4,2,2,2,2,2,0,2023-12-22 04:42:00,0
5184,5183,5183,5183,2028,22,204,22,145,2028,59,22,127,121,119,22,22,204,59,28,28,0,22,4,4,4,4,4,4,2,2,2,6,6,0,2023-12-22 04:44:00,0
5160,5160,5160,5160,2019,24,196,24,145,2019,51,24,123,118,118,24,24,196,51,28,28,0,24,4,4,4,4,4,0,2,2,2,5,5,0,2023-12-22 04:46:00,0
5177,5178,5178,5178,2029,24,200,24,148,2029,52,24,122,119,118,24,24,200,52,31,31,0,24,7,7,7,7,6,2,2,2,2,3,3,1,2023-12-22 04:48:00,0
5176,5176,5176,5176,2025,24,256,24,147,2025,109,24,122,120,119,24,24,256,58,29,29,0,24,5,5,4,4,4,2,2,2,2,2,2,0,2023-12-22 04:50:00,52
5496,5495,5495,5495,2017,70,262,70,189,2017,73,70,166,162,161,70,70,262,73,27,27,0,70,3,3,3,3,3,2,2,2,2,4,4,0,2023-12-22 04:52:00,0
5677,5678,5678,5678,2033,94,275,94,206,2033,69,94,196,194,194,94,94,275,69,28,28,0,94,4,4,4,4,3,0,2,2,2,2,2,1,2023-12-22 04:54:00,0
5644,5642,5642,5642,2021,93,282,93,219,2021,63,93,197,189,188,93,93,282,63,32,32,0,93,8,8,8,8,8,2,2,2,2,8,8,0,2023-12-22 04:56:00,0
5661,5661,5660,5660,2027,96,293,96,210,2027,83,96,189,186,186,96,96,293,83,27,27,0,96,3,3,3,3,3,0,2,2,2,3,3,0,2023-12-22 04:58:00,0
5608,5611,5611,5611,2004,98,266,98,201,2004,65,98,190,188,184,98,98,266,65,27,27,0,98,4,4,4,4,4,8,2,2,2,2,2,0,2023-12-22 05:00:00,0
5641,5640,5640,5640,2014,93,286,93,214,2014,72,93,197,192,188,93,93,286,72,31,31,0,93,7,7,7,7,7,8,2,2,2,5,5,0,2023-12-22 05:02:00,0
5643,5644,5644,5644,2034,91,253,91,200,2034,53,91,181,181,180,91,91,253,53,28,28,0,91,4,4,4,4,3,2,2,2,2,0,0,1,2023-12-22 05:04:00,0
5636,5636,5636,5636,2030,88,266,88,212,2030,54,88,192,190,190,88,88,266,54,28,28,0,88,4,4,4,4,4,0,2,2,2,2,2,0,2023-12-22 05:06:00,0
5631,5630,5630,5630,2031,91,264,91,213,2031,51,91,185,183,183,91,91,264,51,28,28,0,91,4,4,4,4,3,0,2,2,2,2,2,1,2023-12-22 05:08:00,0
5660,5660,5660,5660,2027,100,284,100,219,2027,65,100,192,192,192,100,100,284,65,31,31,0,100,7,7,7,7,7,0,2,2,2,0,0,0,2023-12-22 05:10:00,0
5667,5668,5668,5668,2034,89,285,89,220,2034,65,89,189,186,185,89,89,285,65,28,28,0,89,4,4,4,4,4,2,2,2,2,3,3,0,2023-12-22 05:12:00,0
5649,5649,5649,5649,2019,93,276,93,208,2019,68,93,189,188,187,93,93,276,68,27,27,0,93,3,3,3,3,3,2,2,2,2,1,1,0,2023-12-22 05:14:00,0
5637,5635,5635,5635,2026,94,284,94,209,2026,75,94,186,184,183,94,94,284,75,28,28,0,94,4,4,4,4,4,2,2,2,2,2,2,0,2023-12-22 05:16:00,0
5611,5611,5611,5611,2024,85,265,85,209,2024,56,85,190,189,188,85,85,265,56,31,31,0,85,7,7,7,7,7,2,2,2,2,1,1,0,2023-12-22 05:18:00,0
5613,5615,5615,5615,2026,93,261,93,210,2026,51,93,191,188,186,93,93,261,51,28,28,0,93,4,4,4,4,3,4,2,2,2,3,3,1,2023-12-22 05:20:00,0
5652,5650,5650,5650,2021,90,276,90,215,2021,61,90,200,196,196,90,90,276,61,28,28,0,90,4,4,4,4,4,0,2,2,2,4,4,0,2023-12-22 05:22:00,0
5668,5670,5670,5670,2040,92,291,92,218,2040,73,92,193,191,189,92,92,291,73,31,31,0,92,7,7,7,7,6,4,2,2,2,2,2,1,2023-12-22 05:24:00,0
5639,5638,5638,5638,2014,96,285,96,215,2014,70,96,193,186,184,96,96,285,70,28,28,0,96,4,4,4,4,4,4,2,2,2,7,7,0,2023-12-22 05:26:00,0
5638,5638,5638,5638,2029,96,268,96,213,2029,55,96,196,192,189,96,96,268,55,28,28,0,96,4,4,4,4,4,6,2,2,2,4,4,0,2023-12-22 05:28:00,0
5643,5644,5644,5644,2027,89,274,89,213,2027,61,89,192,188,185,89,89,274,61,27,27,0,89,3,3,3,3,3,6,2,2,2,4,4,0,2023-12-22 05:30:00,0
5633,5633,5633,5633,2026,88,276,88,218,2026,58,88,187,185,184,88,88,276,58,32,32,0,88,8,8,8,8,8,2,2,2,2,2,2,0,2023-12-22 05:32:00,0
5628,5628,5628,5628,2027,86,280,86,212,2027,68,86,191,186,184,86,86,280,68,27,27,0,86,3,3,3,3,3,4,2,2,2,5,5,0,2023-12-22 05:34:00,0
5639,5637,5637,5637,2023,96,283,96,218,2023,65,96,192,187,185,96,96,283,65,28,28,0,96,4,4,4,4,3,4,2,2,2,5,5,1,2023-12-22 05:36:00,0
5647,5649,5649,5649,2030,95,282,95,209,2030,73,95,187,187,186,95,95,282,73,31,31,0,95,7,7,7,7,7,2,2,2,2,0,0,0,2023-12-22 05:38:00,0
5644,5643,5643,5643,2021,90,272,89,223,2021,49,89,205,204,203,89,89,272,49,28,28,0,89,4,4,4,4,3,2,2,2,2,1,1,1,2023-12-22 05:40:00,0
5638,5638,5638,5638,2011,92,282,93,217,2011,65,93,199,195,192,93,93,282,65,28,28,0,93,4,4,4,4,4,6,2,2,2,4,4,0,2023-12-22 05:42:00,0
5641,5642,5642,5642,2037,98,254,98,203,2037,51,98,191,188,186,98,98,254,51,28,28,0,98,4,4,4,4,4,4,2,2,2,3,3,0,2023-12-22 05:44:00,0
5629,5629,5629,5629,2037,95,270,95,214,2037,56,95,177,177,175,95,95,270,56,31,31,0,95,7,7,7,7,7,4,2,2,2,0,0,0,2023-12-22 05:46:00,0
5659,5657,5657,5657,2027,91,257,91,212,2027,45,91,192,188,188,91,91,257,45,28,28,0,91,4,4,4,4,4,0,2,2,2,4,4,0,2023-12-22 05:48:00,0
5558,5560,5560,5560,2014,93,291,93,209,2014,82,93,184,181,179,93,93,291,31,29,29,0,93,5,5,4,4,3,4,2,2,2,3,3,1,2023-12-22 05:50:00,52
5670,5670,5670,5670,2022,96,284,96,221,2022,63,96,195,193,192,96,96,284,63,27,27,0,96,3,3,3,3,3,2,2,2,2,2,2,0,2023-12-22 05:52:00,0
5652,5652,5652,5652,2036,96,265,96,209,2036,56,96,195,193,191,96,96,265,56,31,31,0,96,7,7,7,7,7,4,2,2,2,2,2,0,2023-12-22 05:54:00,0
5628,5628,5628,5628,2018,91,269,91,221,2018,48,91,183,182,181,91,91,269,48,28,28,0,91,4,4,4,4,3,2,2,2,2,1,1,1,2023-12-22 05:56:00,0
5633,5633,5633,5633,2025,93,259,93,208,2025,51,93,196,194,193,93,93,259,51,28,28,0,93,4,4,4,4,4,2,2,2,2,2,2,0,2023-12-22 05:58:00,0
5659,5659,5659,5659,2024,87,273,87,211,2024,62,87,204,198,194,87,87,273,62,31,31,0,87,7,7,7,7,7,8,2,2,2,6,6,0,2023-12-22 06:00:00,0
5606,5607,5606,5606,2006,91,276,91,216,2006,60,91,191,185,185,91,91,276,60,28,28,0,91,4,4,4,4,4,0,2,2,2,6,6,0,2023-12-22 06:02:00,0
5604,5604,5604,5604,2019,90,269,90,209,2019,60,90,180,177,176,90,90,269,60,28,28,0,90,4,4,4,4,4,2,2,2,2,3,3,0,2023-12-22 06:04:00,0
5675,5673,5673,5673,2031,91,277,91,213,2031,64,91,201,199,196,91,91,277,64,28,28,0,91,4,4,4,4,3,6,2,2,2,2,2,1,2023-12-22 06:06:00,0
5635,5636,5636,5636,2022,94,264,94,211,2022,53,94,197,190,189,94,94,264,53,32,32,0,94,7,7,7,7,7,2,2,2,2,7,7,0,2023-12-22 06:08:00,2
5635,5635,5635,5635,2020,90,267,90,198,2020,69,90,197,193,192,90,90,267,69,27,27,0,90,3,3,3,3,3,2,2,2,2,4,4,0,2023-12-22 06:10:00,0
5639,5640,5640,5640,2024,85,278,85,209,2024,69,85,186,182,180,85,85,278,69,28,28,0,85,4,4,4,4,3,4,2,2,2,4,4,1,2023-12-22 06:12:00,0
5608,5607,5607,5607,2011,101,286,101,216,2011,70,101,196,192,191,101,101,286,70,32,32,0,101,8,8,8,8,8,2,2,2,2,4,4,0,2023-12-22 06:14:00,0
5634,5635,5635,5635,2027,82,283,82,206,2027,77,82,191,189,187,82,82,283,77,27,27,0,82,3,3,3,3,3,4,2,2,2,2,2,0,2023-12-22 06:16:00,0
5672,5672,5672,5672,2031,93,268,93,213,2031,55,93,197,193,190,93,93,268,55,28,28,0,93,4,4,4,4,4,6,2,2,2,4,4,0,2023-12-22 06:18:00,0
5664,5663,5663,5663,2027,94,273,94,207,2027,66,94,192,190,189,94,94,273,66,28,28,0,94,4,4,4,4,4,2,2,2,2,2,2,0,2023-12-22 06:20:00,0
5647,5646,5646,5646,2020,109,281,108,216,2020,65,108,199,194,191,108,108,281,65,31,31,0,108,7,7,7,7,6,6,2,2,2,5,5,1,2023-12-22 06:22:00,0
5636,5637,5637,5637,2024,92,273,93,211,2024,62,93,200,197,195,93,93,273,62,28,28,0,93,4,4,4,4,4,4,2,2,2,3,3,0,2023-12-22 06:24:00,0
5623,5624,5624,5624,2026,89,268,89,212,2026,56,89,185,185,184,89,89,268,56,28,28,0,89,4,4,4,4,3,2,2,2,2,0,0,1,2023-12-22 06:26:00,0
5637,5657,5637,5637,2030,92,269,92,212,2030,57,92,196,193,193,92,92,269,57,31,31,0,92,7,7,7,7,7,0,2,2,2,3,3,0,2023-12-22 06:28:00,0
5641,5640,5640,5640,2028,95,280,95,216,2028,64,95,198,191,190,95,95,280,64,28,28,0,95,4,4,4,4,4,2,2,2,2,7,7,0,2023-12-22 06:30:00,0
5654,5655,5655,5655,2028,86,296,86,207,2028,89,86,183,182,181,86,86,296,89,27,27,0,86,3,3,3,3,3,2,2,2,2,1,1,0,2023-12-22 06:32:00,0
5617,5636,5617,5617,2012,86,270,86,219,2012,51,86,188,186,184,86,86,270,51,28,28,0,86,4,4,4,4,4,4,2,2,2,2,2,0,2023-12-22 06:34:00,0
5665,5665,5665,5665,2035,94,268,94,212,2035,56,94,191,186,185,94,94,268,56,31,31,0,94,7,7,7,7,7,2,2,2,2,5,5,0,2023-12-22 06:36:00,0
5605,5605,5605,5605,2012,105,276,105,221,2012,55,105,189,186,184,105,105,276,55,28,28,0,105,4,4,4,4,3,4,2,2,2,3,3,1,2023-12-22 06:38:00,0
5630,5629,5630,5630,2024,97,276,97,213,2024,63,97,190,185,184,97,97,276,63,28,28,0,97,4,4,4,4,4,2,2,2,2,5,5,0,2023-12-22 06:40:00,0
5646,5647,5646,5646,2029,102,284,102,222,2029,62,102,197,192,191,102,102,284,62,28,28,0,102,4,4,4,4,3,2,2,2,2,5,5,1,2023-12-22 06:42:00,0
5662,5661,5661,5661,2028,98,282,98,214,2028,68,98,181,176,176,98,98,282,68,31,31,0,98,7,7,7,7,7,0,2,2,2,5,5,0,2023-12-22 06:44:00,0
5663,5664,5664,5664,2032,96,275,96,219,2032,56,96,194,191,191,96,96,275,56,28,28,0,96,4,4,4,4,4,0,2,2,2,3,3,0,2023-12-22 06:46:00,0
5646,5645,5645,5645,2029,87,262,87,217,2029,45,87,191,190,189,87,87,262,45,27,27,0,87,3,3,3,3,3,2,2,2,2,1,1,0,2023-12-22 06:48:00,0
5616,5617,5617,5617,2025,92,323,92,214,2025,109,92,184,179,179,92,92,323,58,33,33,0,92,9,9,8,8,8,0,2,2,2,5,5,0,2023-12-22 06:50:00,52
5621,5621,5621,5621,2031,82,270,82,215,2031,55,82,189,184,183,82,82,270,55,27,27,0,82,3,3,3,3,3,2,2,2,2,5,5,0,2023-12-22 06:52:00,0
5632,5632,5632,5632,2019,88,273,88,222,2019,51,88,197,194,193,88,88,273,51,28,28,0,88,4,4,4,4,3,2,2,2,2,3,3,1,2023-12-22 06:54:00,0
5665,5665,5665,5665,2033,85,288,85,213,2033,75,85,195,195,194,85,85,288,75,28,28,0,85,4,4,4,4,4,2,2,2,2,0,0,0,2023-12-22 06:56:00,0
5629,5629,5629,5629,2023,88,273,88,221,2023,52,88,204,198,197,88,88,273,52,31,31,0,88,7,7,7,7,6,2,2,2,2,6,6,1,2023-12-22 06:58:00,0
5590,5609,5589,5589,2012,90,277,90,215,2012,62,90,191,186,184,90,90,277,62,28,28,0,90,4,4,4,4,4,4,2,2,2,5,5,0,2023-12-22 07:00:00,0
5639,5640,5640,5640,2010,103,390,103,212,2010,178,103,186,184,181,103,103,390,178,28,28,0,103,4,4,4,4,4,6,2,2,2,2,2,0,2023-12-22 07:02:00,0
5632,5632,5632,5632,2024,91,284,91,218,2024,66,91,185,182,182,91,91,284,66,31,31,0,91,7,7,7,7,7,0,2,2,2,3,3,0,2023-12-22 07:04:00,0
5671,5670,5670,5670,2033,82,288,82,211,2033,77,82,192,190,190,82,82,288,77,28,28,0,82,4,4,4,4,4,0,2,2,2,2,2,0,2023-12-22 07:06:00,0
5681,5700,5681,5681,2026,104,292,104,219,2026,73,104,193,189,186,104,104,292,73,27,27,0,104,3,3,3,3,3,6,2,2,2,4,4,0,2023-12-22 07:08:00,0
5672,5673,5673,5673,2030,96,298,96,215,2030,83,96,194,189,188,96,96,298,83,28,28,0,96,4,4,4,4,3,2,2,2,2,5,5,1,2023-12-22 07:10:00,0
5652,5651,5651,5651,2037,89,282,89,218,2037,64,89,192,189,188,89,89,282,64,31,31,0,89,7,7,7,7,7,2,2,2,2,3,3,0,2023-12-22 07:12:00,0
5649,5649,5649,5649,2032,91,276,91,215,2032,61,91,181,179,178,91,91,276,61,28,28,0,91,4,4,4,4,3,2,2,2,2,2,2,1,2023-12-22 07:14:00,0
5688,5689,5689,5689,2032,84,288,84,209,2032,79,84,193,190,189,84,84,288,79,28,28,0,84,4,4,4,4,4,2,2,2,2,3,3,0,2023-12-22 07:16:00,0
5620,5620,5620,5620,2026,84,285,84,227,2026,58,84,187,185,183,84,84,285,58,28,28,0,84,4,4,4,4,4,4,2,2,2,2,2,0,2023-12-22 07:18:00,0
5679,5679,5679,5679,2023,98,284,98,214,2023,70,98,210,205,201,98,98,284,70,31,31,0,98,7,7,7,7,7,8,2,2,2,5,5,0,2023-12-22 07:20:00,0
5665,5665,5665,5665,2017,100,285,100,223,2017,62,100,198,198,195,100,100,285,62,28,28,0,100,4,4,4,4,4,6,2,2,2,0,0,0,2023-12-22 07:22:00,0
5615,5615,5615,5615,2021,93,263,93,207,2021,56,93,185,183,183,93,93,263,56,28,28,0,93,4,4,4,4,3,0,2,2,2,2,2,1,2023-12-22 07:24:00,0
5562,5562,5562,5562,2001,81,264,81,214,2001,50,81,193,189,187,81,81,264,50,31,31,0,81,7,7,7,7,7,4,2,2,2,4,4,0,2023-12-22 07:26:00,0
5660,5660,5660,5660,2027,94,279,94,215,2027,64,94,191,186,185,94,94,279,64,27,27,0,94,3,3,3,3,3,2,2,2,2,5,5,0,2023-12-22 07:28:00,0
5688,5687,5687,5687,2027,99,289,99,218,2027,71,99,192,189,189,99,99,289,71,28,28,0,99,4,4,4,4,3,0,2,2,2,3,3,1,2023-12-22 07:30:00,0
5591,5592,5592,5592,2018,92,259,92,208,2018,51,92,181,178,177,92,92,259,51,28,28,0,92,4,4,4,4,4,2,2,2,2,3,3,0,2023-12-22 07:32:00,0
5650,5648,5648,5648,2038,87,279,87,217,2038,62,87,181,179,177,87,87,279,62,31,31,0,87,7,7,7,7,7,4,2,2,2,2,2,0,2023-12-22 07:34:00,0
5686,5687,5687,5687,2025,107,282,107,216,2025,66,107,200,198,196,107,107,282,66,28,28,0,107,4,4,4,4,4,4,2,2,2,2,2,0,2023-12-22 07:36:00,0
5625,5626,5626,5626,2025,93,269,93,215,2025,54,93,195,191,190,93,93,269,54,28,28,0,93,4,4,4,4,4,2,2,2,2,4,4,0,2023-12-22 07:38:00,0
5668,5668,5668,5668,2032,90,301,90,222,2032,79,90,186,184,183,90,90,301,79,31,31,0,90,7,7,7,7,6,2,2,2,2,2,2,1,2023-12-22 07:40:00,0
5629,5629,5629,5629,2024,102,264,102,213,2024,51,102,190,187,187,102,102,264,51,28,28,0,102,4,4,4,4,4,0,2,2,2,3,3,0,2023-12-22 07:42:00,0
5668,5668,5668,5668,2029,95,272,95,212,2029,60,95,198,197,196,95,95,272,60,27,27,0,95,3,3,3,3,3,2,2,2,2,1,1,0,2023-12-22 07:44:00,0
5688,5687,5687,5687,2035,94,281,94,221,2035,60,94,192,190,188,94,94,281,60,28,28,0,94,4,4,4,4,3,4,2,2,2,2,2,1,2023-12-22 07:46:00,0
5586,5586,5586,5586,2007,90,266,90,217,2007,49,90,187,185,182,90,90,266,49,31,31,0,90,8,8,8,8,8,6,2,2,2,2,2,0,2023-12-22 07:48:00,0
5657,5657,5657,5657,2036,85,324,85,212,2036,112,85,194,193,188,85,85,324,61,28,28,0,85,4,4,3,3,3,10,2,2,2,1,1,0,2023-12-22 07:50:00,52
5643,5644,5644,5644,2023,92,281,92,218,2023,63,92,190,188,187,92,92,281,63,28,28,0,92,4,4,4,4,4,2,2,2,2,2,2,0,2023-12-22 07:52:00,0
5661,5661,5661,5661,2032,95,280,95,211,2032,69,95,203,196,194,95,95,280,69,28,28,0,95,4,4,4,4,4,4,2,2,2,7,7,0,2023-12-22 07:54:00,0
5650,5650,5650,5650,2032,83,264,83,212,2032,52,83,197,193,193,83,83,264,52,33,33,0,83,7,7,7,7,6,0,2,2,2,4,4,1,2023-12-22 07:56:00,4
5670,5670,5670,5670,2030,91,282,91,227,2030,55,91,196,193,188,91,91,282,55,28,28,0,91,4,4,4,4,4,10,2,2,2,3,3,0,2023-12-22 07:58:00,0
5646,5666,5646,5646,2018,95,279,95,211,2018,68,95,200,196,193,95,95,279,68,28,28,0,95,4,4,4,4,3,6,2,2,2,4,4,1,2023-12-22 08:00:00,0
5627,5626,5626,5626,2019,93,286,93,220,2019,66,93,186,182,179,93,93,286,66,31,31,0,93,7,7,7,7,7,6,2,2,2,4,4,0,2023-12-22 08:02:00,0
5662,5663,5663,5663,2019,96,291,96,213,2019,78,96,192,190,187,96,96,291,78,28,28,0,96,4,4,4,4,4,6,2,2,2,2,2,0,2023-12-22 08:04:00,0
5618,5617,5617,5617,2018,101,266,101,209,2018,57,101,195,192,192,101,101,266,57,27,27,0,101,3,3,3,3,3,0,2,2,2,3,3,0,2023-12-22 08:06:00,0
5642,5643,5643,5643,2029,92,286,92,216,2029,70,92,187,184,183,92,92,286,70,28,28,0,92,4,4,4,4,4,2,2,2,2,3,3,0,2023-12-22 08:08:00,0
5644,5644,5644,5644,2026,96,262,96,212,2026,50,96,195,191,189,96,96,262,50,31,31,0,96,7,7,7,7,7,4,2,2,2,4,4,0,2023-12-22 08:10:00,0
5620,5639,5619,5619,2010,83,273,83,210,2010,63,83,197,194,192,83,83,273,63,28,28,0,83,4,4,4,4,3,4,2,2,2,3,3,1,2023-12-22 08:12:00,0
5678,5679,5679,5679,2029,90,295,90,226,2029,69,90,188,184,181,90,90,295,69,28,28,0,90,4,4,4,4,4,6,2,2,2,4,4,0,2023-12-22 08:14:00,0
5641,5640,5640,5640,2026,97,286,97,220,2026,66,97,192,190,187,97,97,286,66,31,31,0,97,7,7,7,7,6,6,2,2,2,2,2,1,2023-12-22 08:16:00,0
5667,5668,5668,5668,2030,92,286,92,213,2030,73,92,209,202,201,92,92,286,73,28,28,0,92,4,4,4,4,4,2,2,2,2,7,7,0,2023-12-22 08:18:00,0
5642,5643,5642,5642,2024,91,272,91,211,2024,61,91,192,189,184,91,91,272,61,28,28,0,91,4,4,4,4,4,10,2,2,2,3,3,0,2023-12-22 08:20:00,0
5640,5639,5639,5639,2008,113,273,113,210,2008,63,113,187,183,182,113,113,273,63,27,27,0,113,3,3,3,3,3,2,2,2,2,4,4,0,2023-12-22 08:22:00,0
5700,5720,5701,5701,2037,91,287,91,201,2037,86,91,201,196,194,91,91,287,86,32,32,0,91,8,8,8,8,8,4,2,2,2,5,5,0,2023-12-22 08:24:00,0
5674,5673,5673,5673,2043,96,269,96,219,2043,50,96,189,185,185,96,96,269,50,27,27,0,96,3,3,3,3,3,0,2,2,2,4,4,0,2023-12-22 08:26:00,0
5640,5640,5640,5640,2023,93,269,92,210,2023,59,92,192,190,186,92,92,269,59,28,28,0,92,4,4,4,4,3,8,2,2,2,2,2,1,2023-12-22 08:28:00,0
5655,5657,5656,5656,2032,90,275,91,209,2032,66,91,193,190,188,91,91,275,66,28,28,0,91,4,4,4,4,4,4,2,2,2,3,3,0,2023-12-22 08:30:00,0
5681,5680,5680,5680,2030,92,278,92,217,2030,61,92,196,193,189,92,92,278,61,31,31,0,92,7,7,7,7,6,8,2,2,2,3,3,1,2023-12-22 08:32:00,0
5605,5606,5606,5606,2006,90,282,90,220,2006,62,90,191,188,186,90,90,282,62,28,28,0,90,4,4,4,4,4,4,2,2,2,3,3,0,2023-12-22 08:34:00,0
5607,5607,5607,5607,2013,89,277,89,210,2013,67,89,193,189,188,89,89,277,67,28,28,0,89,4,4,4,4,4,2,2,2,2,4,4,0,2023-12-22 08:36:00,0
5686,5686,5686,5686,2028,90,295,90,216,2028,79,90,201,195,191,90,90,295,79,31,31,0,90,7,7,7,7,7,8,2,2,2,6,6,0,2023-12-22 08:38:00,0
5617,5617,5617,5617,2029,85,262,85,206,2029,56,85,184,183,183,85,85,262,56,28,28,0,85,4,4,4,4,4,0,2,2,2,1,1,0,2023-12-22 08:40:00,0
5658,5659,5658,5658,2021,80,276,80,204,2021,72,80,202,197,194,80,80,276,72,27,27,0,80,3,3,3,3,3,6,2,2,2,5,5,0,2023-12-22 08:42:00,0
5637,5637,5637,5637,2017,90,283,90,225,2017,58,90,183,182,181,90,90,283,58,28,28,0,90,4,4,4,4,3,2,2,2,2,1,1,1,2023-12-22 08:44:00,0
5670,5670,5670,5670,2030,90,286,90,216,2030,70,90,195,192,190,90,90,286,70,31,31,0,90,7,7,7,7,7,4,2,2,2,3,3,0,2023-12-22 08:46:00,0
5649,5645,5645,5645,2035,85,269,85,205,2035,64,85,196,188,187,85,85,269,64,28,28,0,85,4,4,4,4,3,2,2,2,2,8,8,1,2023-12-22 08:48:00,0
5647,5651,5651,5651,2028,92,327,92,229,2028,98,92,197,196,195,92,92,327,47,29,29,0,92,5,5,4,4,4,2,2,2,2,1,1,0,2023-12-22 08:50:00,52
5635,5635,5635,5635,2019,90,261,90,216,2019,45,90,186,183,181,90,90,261,45,31,31,0,90,7,7,7,7,7,4,2,2,2,3,3,0,2023-12-22 08:52:00,0
5640,5638,5638,5638,2028,88,283,88,219,2028,64,88,194,190,189,88,88,283,64,28,28,0,88,4,4,4,4,4,2,2,2,2,4,4,0,2023-12-22 08:54:00,0
5615,5617,5617,5617,2014,91,276,91,214,2014,62,91,191,188,186,91,91,276,62,28,28,0,91,4,4,4,4,4,4,2,2,2,3,3,0,2023-12-22 08:56:00,0
5694,5711,5692,5692,2027,104,278,104,210,2027,68,104,201,197,196,104,104,278,68,28,28,0,104,4,4,4,4,3,2,2,2,2,4,4,1,2023-12-22 08:58:00,0
5629,5630,5631,5631,2023,79,286,79,227,2023,59,79,184,181,180,79,79,286,59,31,31,0,79,7,7,7,7,7,2,2,2,2,3,3,0,2023-12-22 09:00:00,0
5618,5619,5618,5618,2016,93,369,93,212,2016,157,93,199,195,193,93,93,369,157,27,27,0,93,3,3,3,3,3,4,2,2,2,4,4,0,2023-12-22 09:02:00,0
5617,5617,5617,5617,2022,97,262,97,221,2022,41,97,188,186,182,97,97,262,41,28,28,0,97,4,4,4,4,3,8,2,2,2,2,2,1,2023-12-22 09:04:00,0
5662,5659,5659,5659,2041,88,286,88,210,2041,76,88,192,186,186,88,88,286,76,28,28,0,88,4,4,4,4,4,0,2,2,2,6,6,0,2023-12-22 09:06:00,0
5629,5632,5632,5632,2031,84,278,84,220,2031,58,84,190,186,182,84,84,278,58,31,31,0,84,7,7,7,7,7,8,2,2,2,4,4,0,2023-12-22 09:08:00,0
5666,5666,5666,5666,2030,93,282,93,210,2030,72,93,194,187,185,93,93,282,72,28,28,0,93,4,4,4,4,4,4,2,2,2,7,7,0,2023-12-22 09:10:00,0
5688,5707,5687,5687,2035,99,289,99,212,2035,77,99,198,193,188,99,99,289,77,28,28,0,99,4,4,4,4,4,10,2,2,2,5,5,0,2023-12-22 09:12:00,0
5643,5644,5644,5644,2022,92,279,92,209,2022,70,92,200,193,191,92,92,279,70,31,31,0,92,7,7,7,7,6,4,2,2,2,7,7,1,2023-12-22 09:14:00,0
5639,5639,5639,5639,2014,86,288,86,215,2014,73,86,196,190,187,86,86,288,73,28,28,0,86,4,4,4,4,4,6,2,2,2,6,6,0,2023-12-22 09:16:00,0
5679,5679,5679,5679,2034,88,300,88,221,2034,79,88,192,191,190,88,88,300,79,27,27,0,88,3,3,3,3,3,2,2,2,2,1,1,0,2023-12-22 09:18:00,0
5631,5631,5631,5631,2016,92,286,92,218,2016,68,92,189,189,188,92,92,286,68,28,28,0,92,4,4,4,4,3,2,2,2,2,0,0,1,2023-12-22 09:20:00,0
5638,5656,5637,5637,2017,104,285,104,214,2017,71,104,185,182,180,104,104,285,71,32,32,0,104,8,8,8,8,8,4,2,2,2,3,3,0,2023-12-22 09:22:00,0
5661,5662,5662,5662,2030,99,271,99,210,2030,61,99,189,185,183,99,99,271,61,27,27,0,99,3,3,3,3,3,4,2,2,2,4,4,0,2023-12-22 09:24:00,0
5656,5656,5656,5656,2023,90,277,90,219,2023,58,90,195,193,192,90,90,277,58,28,28,0,90,4,4,4,4,4,2,2,2,2,2,2,0,2023-12-22 09:26:00,0
5638,5637,5637,5637,2033,90,265,90,212,2033,53,90,189,188,187,90,90,265,53,28,28,0,90,4,4,4,4,4,2,2,2,2,1,1,0,2023-12-22 09:28:00,0
5616,5618,5617,5617,2020,88,278,88,214,2020,64,88,190,185,184,88,88,278,64,31,31,0,88,7,7,7,7,6,2,2,2,2,5,5,1,2023-12-22 09:30:00,0
5662,5662,5662,5662,2025,90,287,90,210,2025,77,90,188,184,181,90,90,287,77,28,28,0,90,4,4,4,4,4,6,2,2,2,4,4,0,2023-12-22 09:32:00,0
5645,5644,5644,5644,2012,96,272,96,208,2012,64,96,199,195,192,96,96,272,64,28,28,0,96,4,4,4,4,3,6,2,2,2,4,4,1,2023-12-22 09:34:00,0
5687,5687,5687,5687,2021,99,293,99,229,2021,64,99,202,199,197,99,99,293,64,31,31,0,99,7,7,7,7,7,4,2,2,2,3,3,0,2023-12-22 09:36:00,0
5640,5639,5639,5639,2024,91,263,91,207,2024,56,91,200,197,195,91,91,263,56,28,28,0,91,4,4,4,4,4,4,2,2,2,3,3,0,2023-12-22 09:38:00,0
5672,5673,5672,5672,2037,92,290,92,216,2037,74,92,192,189,189,92,92,290,74,27,27,0,92,3,3,3,3,3,0,2,2,2,3,3,0,2023-12-22 09:40:00,0
5664,5666,5666,5666,2026,93,289,93,214,2026,75,93,187,185,185,93,93,289,75,28,28,0,93,4,4,4,4,4,0,2,2,2,2,2,0,2023-12-22 09:42:00,0
5670,5669,5669,5669,2037,88,279,88,220,2037,59,88,189,185,182,88,88,279,59,31,31,0,88,7,7,7,7,7,6,2,2,2,4,4,0,2023-12-22 09:44:00,0
5550,5550,5550,5550,1993,88,273,88,205,1993,68,88,177,173,170,88,88,273,68,28,28,0,88,4,4,4,4,3,6,2,2,2,4,4,1,2023-12-22 09:46:00,0
5634,5634,5633,5633,2025,90,265,90,217,2025,48,90,188,185,185,90,90,265,48,30,30,0,90,5,4,4,4,4,0,2,2,2,3,3,0,2023-12-22 09:48:00,3
5641,5642,5642,5642,2036,87,326,87,224,2036,102,87,178,177,176,87,87,326,51,32,32,0,87,8,8,7,7,6,2,2,2,2,1,1,1,2023-12-22 09:50:00,52
5617,5618,5618,5618,2022,78,269,78,208,2022,61,78,208,201,199,78,78,269,61,28,28,0,78,4,4,4,4,4,4,2,2,2,7,7,0,2023-12-22 09:52:00,0
5664,5664,5664,5664,2024,104,288,104,225,2024,63,104,190,189,188,104,104,288,63,28,28,0,104,4,4,4,4,4,2,2,2,2,1,1,0,2023-12-22 09:54:00,0
5649,5649,5649,5649,2040,95,262,95,214,2040,48,95,182,180,178,95,95,262,48,27,27,0,95,3,3,3,3,3,4,2,2,2,2,2,0,2023-12-22 09:56:00,0
5633,5633,5633,5633,2016,100,281,100,214,2016,67,100,194,193,192,100,100,281,67,32,32,0,100,8,8,8,8,8,2,2,2,2,1,1,0,2023-12-22 09:58:00,0
5663,5663,5663,5663,2030,90,269,90,217,2030,52,90,193,192,192,90,90,269,52,27,27,0,90,3,3,3,3,3,0,2,2,2,1,1,0,2023-12-22 10:00:00,0
5629,5629,5629,5629,2015,95,281,95,224,2015,57,95,196,194,193,95,95,281,57,30,30,0,95,5,4,4,4,3,2,2,2,2,2,2,1,2023-12-22 10:02:00,3
5621,5619,5619,5619,2020,91,256,91,209,2020,47,91,194,189,187,91,91,256,47,28,28,0,91,4,4,4,4,4,4,2,2,2,5,5,0,2023-12-22 10:04:00,0
5647,5649,5649,5649,2016,106,288,106,215,2016,73,106,204,201,199,106,106,288,73,31,31,0,106,7,7,7,7,6,4,2,2,2,3,3,1,2023-12-22 10:06:00,0
5644,5644,5644,5644,2027,92,271,92,208,2027,63,92,193,190,185,92,92,271,63,28,28,0,92,4,4,4,4,4,10,2,2,2,3,3,0,2023-12-22 10:08:00,0
5588,5589,5588,5588,2005,82,291,82,208,2005,83,82,188,184,183,82,82,291,83,28,28,0,82,4,4,4,4,4,2,2,2,2,4,4,0,2023-12-22 10:10:00,0
5663,5662,5662,5662,2022,95,290,95,216,2022,74,95,188,185,183,95,95,290,74,31,31,0,95,7,7,7,7,7,4,2,2,2,3,3,0,2023-12-22 10:12:00,0
5645,5644,5644,5644,2033,83,278,83,209,2033,69,83,198,192,191,83,83,278,69,34,34,0,83,7,4,4,4,4,2,2,2,2,6,6,0,2023-12-22 10:14:00,9
5657,5659,5659,5659,2016,95,291,95,220,2016,71,95,191,187,187,95,95,291,71,27,27,0,95,3,3,3,3,3,0,2,2,2,4,4,0,2023-12-22 10:16:00,0
5643,5643,5643,5643,2018,102,268,102,215,2018,53,102,194,191,190,102,102,268,53,28,28,0,102,4,4,4,4,3,2,2,2,2,3,3,1,2023-12-22 10:18:00,0
5644,5644,5644,5644,2024,88,270,88,211,2024,59,88,197,193,190,88,88,270,59,31,31,0,88,7,7,7,7,7,6,2,2,2,4,4,0,2023-12-22 10:20:00,0
5701,5700,5701,5701,2033,88,323,88,249,2033,74,88,198,191,190,88,88,323,74,64,64,0,88,22,4,4,4,3,2,2,2,2,7,7,1,2023-12-22 10:22:00,54
5672,5672,5672,5672,2025,89,320,89,244,2025,76,89,201,196,194,89,89,320,76,58,58,0,89,19,4,4,4,4,4,2,2,2,5,5,0,2023-12-22 10:24:00,45
5660,5658,5658,5658,2020,102,293,102,226,2020,67,102,192,188,186,102,102,293,67,33,33,0,102,8,7,7,7,7,4,2,2,2,4,4,0,2023-12-22 10:26:00,3
5655,5655,5656,5656,2012,94,291,94,209,2012,82,94,196,193,190,94,94,291,82,28,28,0,94,4,4,4,4,4,6,2,2,2,3,3,0,2023-12-22 10:28:00,0
5654,5655,5655,5655,2031,96,281,96,216,2031,65,96,188,184,182,96,96,281,65,28,28,0,96,4,4,4,4,4,4,2,2,2,4,4,0,2023-12-22 10:30:00,0
5626,5624,5624,5624,2012,89,277,89,208,2012,69,89,201,199,198,89,88,277,69,27,27,4,89,4,4,4,4,3,2,2,2,2,2,2,1,2023-12-22 10:32:00,0
5629,5630,5630,5630,2009,92,316,92,226,2009,90,92,194,191,188,92,93,316,90,49,49,0,92,16,7,7,7,7,6,2,2,2,3,3,0,2023-12-22 10:34:00,27
5685,5686,5685,5685,2033,91,299,91,222,2033,77,91,198,191,190,91,91,299,77,27,27,7,91,3,3,3,3,3,2,2,2,2,7,7,0,2023-12-22 10:36:00,0
5721,5722,5722,5722,2032,89,318,89,212,2032,106,89,208,197,191,89,89,318,106,28,28,0,89,4,4,4,4,3,12,2,2,2,11,11,1,2023-12-22 10:38:00,0
5730,5728,5728,5728,2026,96,348,96,213,2026,135,96,204,196,193,96,96,348,135,28,28,0,96,4,4,4,4,4,6,2,2,2,8,8,0,2023-12-22 10:40:00,0
5673,5674,5675,5675,2015,85,322,85,217,2015,105,85,198,194,192,85,85,322,105,31,31,0,85,7,7,7,7,7,4,2,2,2,4,4,0,2023-12-22 10:42:00,0
5690,5690,5690,5690,2020,88,353,88,223,2020,130,88,191,188,186,88,88,353,130,30,30,0,88,5,4,4,4,4,4,2,2,2,3,3,0,2023-12-22 10:44:00,3
5680,5679,5679,5679,2016,95,327,90,218,2017,109,90,212,203,196,90,89,327,109,34,34,0,89,7,4,4,4,4,14,2,2,2,9,9,0,2023-12-22 10:46:00,11
5666,5687,5667,5667,2018,81,328,81,215,2018,113,81,196,185,181,81,81,328,113,31,31,0,81,7,7,7,7,6,8,2,2,2,11,11,1,2023-12-22 10:48:00,0
5624,5623,5623,5623,1998,96,364,96,210,1998,154,96,188,181,179,96,96,364,103,29,29,0,96,5,5,4,4,4,4,2,2,2,7,7,0,2023-12-22 10:50:00,52
5664,5665,5665,5665,2014,103,326,103,218,2014,108,103,186,181,178,103,103,326,108,27,27,0,103,3,3,3,3,3,6,2,2,2,5,5,0,2023-12-22 10:52:00,0
5681,5679,5679,5679,2012,89,341,89,212,2012,129,89,193,186,185,89,89,341,129,28,28,0,89,4,4,4,4,3,2,2,2,2,7,7,1,2023-12-22 10:54:00,0
5653,5653,5653,5653,2006,88,343,88,207,2006,136,88,198,192,188,88,88,343,136,32,32,0,88,8,8,8,8,8,8,2,2,2,6,6,0,2023-12-22 10:56:00,0
5719,5740,5720,5720,2023,97,347,92,212,2024,135,92,206,199,198,92,91,347,135,27,27,0,91,3,3,3,3,3,2,2,2,2,7,7,0,2023-12-22 10:58:00,2
5715,5716,5716,5716,2026,111,322,111,217,2026,105,111,195,193,190,111,111,322,105,28,28,0,111,4,4,4,4,4,6,2,2,2,2,2,0,2023-12-22 11:00:00,0
5726,5725,5725,5725,2016,89,552,89,216,2016,336,89,201,190,185,89,89,552,336,28,28,0,89,4,4,4,4,4,10,2,2,2,11,11,0,2023-12-22 11:02:00,0
5755,5756,5756,5756,2031,93,363,93,216,2031,147,93,210,203,200,93,93,363,147,31,31,3,93,7,7,7,7,6,6,2,2,2,7,7,1,2023-12-22 11:04:00,0
5691,5692,5691,5691,2022,94,334,94,209,2022,125,94,182,174,172,94,94,334,125,28,28,6,94,4,4,4,4,4,4,2,2,2,8,8,0,2023-12-22 11:06:00,0
5679,5680,5679,5679,2027,87,313,87,215,2027,98,87,197,193,191,87,87,313,98,28,28,0,87,4,4,4,4,3,4,2,2,2,4,4,1,2023-12-22 11:08:00,0
5750,5747,5747,5747,2023,90,370,90,207,2023,163,90,203,196,192,90,90,370,163,31,31,0,90,7,7,7,7,7,8,2,2,2,7,7,0,2023-12-22 11:10:00,0
5749,5750,5750,5750,2022,98,352,98,209,2022,143,98,201,195,188,98,98,352,143,28,28,10,98,4,4,4,4,4,14,2,2,2,6,6,0,2023-12-22 11:12:00,0
5700,5703,5702,5702,2019,94,362,94,217,2019,145,94,184,181,178,94,94,362,145,27,27,4,94,3,3,3,3,3,6,2,2,2,3,3,0,2023-12-22 11:14:00,0
5666,5667,5666,5666,2020,88,328,88,203,2020,125,88,202,200,197,88,88,328,125,28,28,0,88,4,4,4,4,4,6,2,2,2,2,2,0,2023-12-22 11:16:00,0
5682,5683,5682,5682,2010,89,363,89,221,2010,142,89,203,194,189,89,89,363,142,31,31,0,89,7,7,7,7,7,10,2,2,2,9,9,0,2023-12-22 11:18:00,0
5736,5735,5735,5735,2030,94,341,94,212,2030,129,94,200,194,192,94,94,341,129,28,28,0,94,4,4,4,4,3,4,2,2,2,6,6,1,2023-12-22 11:20:00,0
5667,5671,5668,5668,2018,88,347,88,214,2018,133,88,189,182,180,88,88,347,133,28,28,11,88,4,4,4,4,4,4,2,2,2,7,7,0,2023-12-22 11:22:00,0
5741,5740,5740,5740,2034,96,337,96,214,2034,123,96,203,200,196,96,96,337,123,28,28,0,96,4,4,4,4,3,8,2,2,2,3,3,1,2023-12-22 11:24:00,0
5735,5734,5734,5734,2029,88,353,88,229,2029,124,88,202,198,194,88,88,353,124,31,31,0,88,7,7,7,7,7,8,2,2,2,4,4,0,2023-12-22 11:26:00,0
5735,5736,5736,5736,2019,101,371,101,215,2019,156,101,201,195,193,101,101,371,156,28,28,0,101,4,4,4,4,4,4,2,2,2,6,6,0,2023-12-22 11:28:00,0
5682,5683,5683,5683,2019,85,331,85,215,2019,116,85,204,196,193,85,85,331,116,27,27,0,85,3,3,3,3,3,6,2,2,2,8,8,0,2023-12-22 11:30:00,0
5724,5745,5724,5724,2024,97,368,97,223,2024,145,97,198,188,185,97,97,368,145,32,32,10,97,8,8,8,8,8,6,2,2,2,10,10,0,2023-12-22 11:32:00,0
5680,5680,5679,5679,2021,84,347,79,217,2022,130,79,196,186,183,79,78,347,130,27,27,8,78,3,3,3,3,3,6,2,2,2,10,10,0,2023-12-22 11:34:00,2
5700,5701,5701,5701,2034,88,334,88,211,2034,123,88,198,190,189,88,88,334,123,28,28,1,88,4,4,4,4,3,2,2,2,2,8,8,1,2023-12-22 11:36:00,0
5732,5731,5731,5731,2033,78,369,78,211,2033,158,78,213,203,199,78,78,369,158,28,28,13,78,4,4,4,4,4,8,2,2,2,10,10,0,2023-12-22 11:38:00,0
5687,5688,5687,5687,2018,95,344,95,207,2018,137,95,198,193,188,95,95,344,137,31,31,0,95,7,7,7,7,6,10,2,2,2,5,5,1,2023-12-22 11:40:00,0
5639,5640,5639,5639,1987,114,360,109,211,1988,149,109,192,182,178,109,108,360,149,28,28,4,108,4,4,4,4,4,8,2,2,2,10,10,0,2023-12-22 11:42:00,2
5688,5689,5688,5688,2027,82,328,82,203,2027,125,82,197,189,185,82,82,328,125,28,28,0,82,4,4,4,4,4,8,2,2,2,8,8,0,2023-12-22 11:44:00,0
5711,5710,5710,5710,2016,90,356,85,221,2017,135,85,193,193,191,85,84,356,135,27,27,0,84,3,3,3,3,3,4,2,2,2,0,0,0,2023-12-22 11:46:00,4
5726,5727,5727,5727,2024,84,336,84,224,2024,112,84,201,195,191,84,84,336,112,32,32,4,84,8,8,8,8,8,8,2,2,2,6,6,0,2023-12-22 11:48:00,0
5666,5664,5664,5664,2029,88,366,88,223,2029,143,88,180,179,178,88,88,366,92,28,28,0,88,4,4,3,3,3,2,2,2,2,1,1,0,2023-12-22 11:50:00,52
5695,5697,5697,5697,2025,81,327,81,207,2025,120,81,198,192,191,81,81,327,120,28,28,9,81,4,4,4,4,3,2,2,2,2,6,6,1,2023-12-22 11:52:00,0
5726,5725,5723,5723,2023,96,332,96,211,2023,121,96,217,200,192,96,96,332,121,31,31,1,96,7,7,7,7,7,16,2,2,2,17,17,0,2023-12-22 11:54:00,0
5766,5772,5768,5768,2027,83,389,83,216,2027,173,83,195,186,182,83,83,389,173,28,28,1,83,4,4,4,4,3,8,2,2,2,9,9,1,2023-12-22 11:56:00,0
5698,5700,5700,5700,2031,90,315,90,208,2031,107,90,201,196,193,90,90,315,107,28,28,2,90,4,4,4,4,4,6,2,2,2,5,5,0,2023-12-22 11:58:00,0
5685,5684,5684,5684,2016,95,330,95,210,2016,120,95,195,183,180,95,95,330,120,28,28,0,95,4,4,4,4,4,6,2,2,2,12,12,0,2023-12-22 12:00:00,0
5739,5738,5738,5738,2012,93,575,93,221,2012,354,93,209,201,196,93,93,575,354,31,31,0,93,7,7,7,7,7,10,2,2,2,8,8,0,2023-12-22 12:02:00,0
5709,5711,5711,5711,2020,93,378,93,214,2020,164,93,192,181,174,93,93,378,164,28,28,2,93,4,4,4,4,4,14,2,2,2,11,11,0,2023-12-22 12:04:00,0
5718,5716,5716,5716,2028,84,359,83,213,2028,146,83,200,191,187,83,83,359,146,28,28,0,83,4,4,4,4,3,8,2,2,2,9,9,1,2023-12-22 12:06:00,0
5735,5737,5737,5737,2020,95,353,96,212,2020,141,96,210,203,198,96,96,353,141,27,27,6,96,3,3,3,3,3,10,2,2,2,7,7,0,2023-12-22 12:08:00,0
5733,5731,5731,5731,2033,87,341,87,220,2033,121,87,199,192,189,87,87,341,121,31,31,12,87,7,7,7,7,7,6,2,2,2,7,7,0,2023-12-22 12:10:00,0
5774,5776,5776,5776,2021,104,382,104,208,2021,174,104,208,197,192,104,104,382,174,28,28,0,104,4,4,4,4,3,10,2,2,2,11,11,1,2023-12-22 12:12:00,0
5695,5695,5695,5695,2024,92,341,92,218,2024,123,92,195,193,188,92,92,341,123,28,28,16,92,4,4,4,4,4,10,2,2,2,2,2,0,2023-12-22 12:14:00,0
5731,5730,5730,5730,2028,85,372,85,221,2028,151,85,194,191,187,85,85,372,151,31,31,1,85,7,7,7,7,7,8,2,2,2,3,3,0,2023-12-22 12:16:00,0
5750,5750,5750,5750,2025,96,371,96,221,2025,150,96,196,188,186,96,96,371,150,28,28,4,96,4,4,4,4,4,4,2,2,2,8,8,0,2023-12-22 12:18:00,0
5732,5733,5732,5732,2022,88,350,88,224,2022,126,88,192,186,179,88,88,350,126,28,28,0,88,4,4,4,4,4,14,2,2,2,6,6,0,2023-12-22 12:20:00,0
5702,5701,5701,5701,2013,91,350,91,211,2013,139,91,195,187,182,91,91,350,139,28,28,0,91,4,4,4,4,3,10,2,2,2,8,8,1,2023-12-22 12:22:00,0
5741,5743,5743,5743,2028,103,357,103,219,2028,138,103,202,192,188,103,103,357,138,31,31,0,103,7,7,7,7,7,8,2,2,2,10,10,0,2023-12-22 12:24:00,0
5752,5752,5752,5752,2028,102,369,102,214,2028,155,102,192,183,181,102,102,369,155,27,27,0,102,3,3,3,3,3,4,2,2,2,9,9,0,2023-12-22 12:26:00,0
5673,5672,5672,5672,2003,82,339,82,209,2003,130,82,207,200,196,82,82,339,130,28,28,1,82,4,4,4,4,3,8,2,2,2,7,7,1,2023-12-22 12:28:00,0
5683,5684,5684,5684,2020,90,329,90,206,2020,123,90,195,185,180,90,90,329,123,28,28,1,90,4,4,4,4,4,10,2,2,2,10,10,0,2023-12-22 12:30:00,0
5698,5697,5697,5697,2026,93,332,93,218,2026,114,93,189,186,183,93,93,332,114,31,31,0,93,7,7,7,7,7,6,2,2,2,3,3,0,2023-12-22 12:32:00,0
5746,5747,5747,5747,2018,98,346,98,210,2018,136,98,197,190,187,98,98,346,136,28,28,0,98,4,4,4,4,4,6,2,2,2,7,7,0,2023-12-22 12:34:00,0
5724,5722,5722,5722,2020,86,366,86,215,2020,151,86,197,193,189,86,86,366,151,28,28,1,86,4,4,4,4,4,8,2,2,2,4,4,0,2023-12-22 12:36:00,0
5701,5702,5702,5702,2024,94,321,94,210,2024,111,94,195,192,184,94,94,321,111,28,28,0,94,4,4,4,4,3,16,2,2,2,3,3,1,2023-12-22 12:38:00,0
5674,5673,5673,5673,2026,81,323,81,208,2026,115,81,201,197,195,81,81,323,115,31,31,4,81,7,7,7,7,7,4,2,2,2,4,4,0,2023-12-22 12:40:00,0
5702,5703,5703,5703,2019,87,346,87,219,2019,127,87,195,191,187,87,87,346,127,27,27,0,87,3,3,3,3,3,8,2,2,2,4,4,0,2023-12-22 12:42:00,0
5750,5750,5750,5750,2034,97,343,97,204,2034,139,97,205,200,196,97,97,343,139,28,28,4,97,4,4,4,4,3,8,2,2,2,5,5,1,2023-12-22 12:44:00,0
5725,5746,5726,5726,2030,103,329,103,213,2030,116,103,181,175,172,103,103,329,116,28,28,0,103,4,4,4,4,4,6,2,2,2,6,6,0,2023-12-22 12:46:00,0
5664,5664,5664,5664,2012,95,329,95,210,2012,119,95,202,194,191,95,95,329,119,31,31,0,95,7,7,7,7,7,6,2,2,2,8,8,0,2023-12-22 12:48:00,0
5680,5678,5678,5678,2023,94,368,94,207,2023,161,94,198,194,191,94,94,368,110,29,29,4,94,5,5,4,4,4,6,2,2,2,4,4,0,2023-12-22 12:50:00,52
5672,5672,5672,5672,2029,90,304,90,207,2029,97,90,199,195,193,90,90,304,97,28,28,0,90,4,4,4,4,4,4,2,2,2,4,4,0,2023-12-22 12:52:00,0
5731,5733,5732,5732,2024,97,348,97,224,2024,124,97,190,181,177,97,97,348,124,31,31,4,97,7,7,7,7,6,8,2,2,2,9,9,1,2023-12-22 12:54:00,0
5753,5753,5753,5753,2035,83,370,83,216,2035,154,83,201,192,190,83,83,370,154,28,28,0,83,4,4,4,4,4,4,2,2,2,9,9,0,2023-12-22 12:56:00,0
5722,5722,5722,5722,2023,86,349,86,214,2023,135,86,203,200,195,86,86,349,135,27,27,0,86,3,3,3,3,3,10,2,2,2,3,3,0,2023-12-22 12:58:00,0
5714,5715,5715,5715,2034,101,330,101,217,2034,113,101,197,187,183,101,101,330,113,28,28,0,101,4,4,4,4,3,8,2,2,2,10,10,1,2023-12-22 13:00:00,0
5740,5739,5739,5739,2020,93,561,93,217,2020,344,93,197,190,186,93,93,561,344,32,32,0,93,8,8,8,8,8,8,2,2,2,7,7,0,2023-12-22 13:02:00,0
5676,5676,5676,5676,2024,100,313,100,211,2024,102,100,202,191,190,100,100,313,102,27,27,1,100,3,3,3,3,3,2,2,2,2,11,11,0,2023-12-22 13:04:00,0
5739,5739,5739,5739,2017,91,360,91,216,2017,144,91,191,184,181,91,91,360,144,28,28,1,91,4,4,4,4,4,6,2,2,2,7,7,0,2023-12-22 13:06:00,0
5745,5747,5745,5745,2030,84,363,84,226,2030,137,84,188,181,176,84,84,363,137,28,28,0,84,4,4,4,4,4,10,2,2,2,7,7,0,2023-12-22 13:08:00,0
5677,5678,5678,5678,2017,83,330,83,215,2017,115,83,195,188,184,83,83,330,115,31,31,2,83,7,7,7,7,6,8,2,2,2,7,7,1,2023-12-22 13:10:00,0
5683,5685,5683,5683,2010,103,337,103,207,2010,130,103,191,184,180,103,103,337,130,27,27,0,103,4,4,4,4,4,8,2,2,2,7,7,0,2023-12-22 13:12:00,0
5706,5705,5705,5705,2028,90,322,90,206,2028,116,90,207,204,201,90,90,322,116,28,28,0,90,4,4,4,4,3,6,2,2,2,3,3,1,2023-12-22 13:14:00,0
5747,5748,5748,5748,2034,90,348,90,223,2034,125,90,208,195,193,90,90,348,125,27,27,2,90,3,3,3,3,3,4,2,2,2,13,13,0,2023-12-22 13:16:00,0
5715,5715,5715,5715,2022,101,347,101,226,2022,121,101,199,190,188,101,101,347,121,32,32,0,101,8,8,8,8,8,4,2,2,2,9,9,0,2023-12-22 13:18:00,0
5732,5731,5731,5731,2023,91,353,91,217,2023,136,91,203,194,186,91,91,353,136,27,27,4,91,3,3,3,3,3,16,2,2,2,9,9,0,2023-12-22 13:20:00,0
5702,5702,5702,5702,2020,85,352,85,207,2020,145,85,201,194,191,85,85,352,145,28,28,0,85,4,4,4,4,4,6,2,2,2,7,7,0,2023-12-22 13:22:00,0
5729,5730,5730,5730,2019,94,362,94,220,2019,142,94,205,195,190,94,94,362,142,31,31,0,94,7,7,7,7,7,10,2,2,2,10,10,0,2023-12-22 13:24:00,0
5741,5741,5741,5741,2026,90,356,90,212,2026,144,90,190,185,182,90,90,356,144,28,28,0,90,4,4,4,4,3,6,2,2,2,5,5,1,2023-12-22 13:26:00,0
5710,5709,5709,5709,2033,84,330,84,215,2033,115,84,197,191,190,84,84,330,115,29,29,0,84,4,4,4,4,4,2,2,2,2,6,6,0,2023-12-22 13:28:00,0
5720,5721,5721,5721,2031,93,326,93,217,2031,109,93,210,200,200,93,93,326,109,28,28,1,93,4,4,4,4,3,0,2,2,2,10,10,1,2023-12-22 13:30:00,0
5679,5679,5679,5679,2014,88,344,88,212,2014,132,88,193,186,182,88,88,344,132,30,30,6,88,7,7,7,7,7,8,2,2,2,7,7,0,2023-12-22 13:32:00,0
5759,5758,5758,5758,2029,101,367,101,209,2029,158,101,200,194,190,101,101,367,158,28,28,0,101,4,4,4,4,4,8,2,2,2,6,6,0,2023-12-22 13:34:00,0
5714,5714,5714,5714,2031,90,342,90,211,2031,131,90,187,180,175,90,90,342,131,27,27,2,90,3,3,3,3,3,10,2,2,2,7,7,0,2023-12-22 13:36:00,0
5744,5745,5745,5745,2028,90,348,90,216,2028,132,90,200,193,185,90,90,348,132,28,28,0,90,4,4,4,4,4,16,2,2,2,7,7,0,2023-12-22 13:38:00,0
5757,5757,5757,5757,2028,101,361,101,214,2028,147,101,207,199,194,101,101,361,147,31,31,0,101,7,7,7,7,7,10,2,2,2,8,8,0,2023-12-22 13:40:00,0
5718,5717,5717,5717,2016,88,374,87,228,2016,146,87,179,173,172,87,87,374,146,28,28,4,87,4,4,4,4,3,2,2,2,2,6,6,1,2023-12-22 13:42:00,0
5745,5744,5744,5744,2032,90,370,91,219,2032,151,91,201,192,189,91,91,370,151,28,28,0,91,4,4,4,4,4,6,2,2,2,9,9,0,2023-12-22 13:44:00,0
5696,5698,5698,5698,2019,90,334,90,208,2019,126,90,197,194,191,90,90,334,126,28,28,4,90,4,4,4,4,3,6,2,2,2,3,3,1,2023-12-22 13:46:00,0
5707,5707,5707,5707,2033,104,330,104,215,2033,115,104,189,186,184,104,104,330,115,31,31,0,104,7,7,7,7,7,4,2,2,2,3,3,0,2023-12-22 13:48:00,0
5687,5687,5687,5687,2032,85,361,85,219,2032,142,85,191,186,184,85,85,361,91,29,29,0,85,5,5,4,4,4,4,2,2,2,5,5,0,2023-12-22 13:50:00,52
5722,5722,5722,5722,2025,94,349,94,218,2025,131,94,199,192,191,94,94,349,131,27,27,2,94,3,3,3,3,3,2,2,2,2,7,7,0,2023-12-22 13:52:00,0
5685,5685,5685,5685,2017,87,330,87,211,2017,119,87,199,196,196,87,87,330,119,32,32,0,87,8,8,8,8,8,0,2,2,2,3,3,0,2023-12-22 13:54:00,0
5691,5689,5689,5689,2026,91,332,91,211,2026,121,91,203,194,190,91,91,332,121,27,27,2,91,3,3,3,3,3,8,2,2,2,9,9,0,2023-12-22 13:56:00,0
5700,5701,5701,5701,2018,95,356,95,203,2018,153,95,192,182,180,95,95,356,153,28,28,0,95,4,4,4,4,3,4,2,2,2,10,10,1,2023-12-22 13:58:00,0
5667,5668,5668,5668,2012,91,318,91,210,2012,108,91,193,188,186,91,91,318,108,28,28,0,91,4,4,4,4,4,4,2,2,2,5,5,0,2023-12-22 14:00:00,0
1255,1254,1254,1254,433,13,115,13,56,433,59,13,42,42,39,13,13,115,59,8,8,0,13,3,3,3,3,3,6,1,1,1,0,0,0,2023-12-22 14:02:00,0
0,0,0,0,0,0,0,0,0,0,0,0,0,0,0,0,0,0,0,0,0,0,0,0,0,0,0,0,0,0,0,0,0,0,0,2023-12-22 14:04:00,0
982,982,982,982,352,16,42,16,42,352,0,16,41,41,41,16,16,42,0,4,4,0,16,0,0,0,0,0,0,0,0,0,0,0,0,2023-12-22 14:06:00,0
5732,5732,5732,5732,2017,102,349,102,205,2017,144,102,204,195,189,102,102,349,144,27,27,2,102,3,3,3,3,3,12,2,2,2,9,9,0,2023-12-22 14:08:00,0
5705,5706,5706,5706,2021,92,349,92,225,2021,124,92,206,198,193,92,92,349,124,32,32,0,92,8,8,8,8,8,10,2,2,2,8,8,0,2023-12-22 14:10:00,0
5729,5729,5729,5729,2023,90,344,90,213,2023,131,90,209,200,198,90,90,344,131,27,27,4,90,3,3,3,3,3,4,2,2,2,9,9,0,2023-12-22 14:12:00,0
5740,5739,5739,5739,2026,109,343,109,213,2026,130,109,203,195,193,109,109,343,130,28,28,0,109,4,4,4,4,3,4,2,2,2,8,8,1,2023-12-22 14:14:00,0
5731,5732,5732,5732,2037,96,337,96,207,2037,130,96,196,185,183,96,96,337,130,28,28,0,96,4,4,4,4,4,4,2,2,2,11,11,0,2023-12-22 14:16:00,0
5666,5667,5666,5666,2014,76,332,76,213,2014,119,76,182,175,172,76,76,332,119,31,31,4,76,7,7,7,7,6,6,2,2,2,7,7,1,2023-12-22 14:18:00,0
5736,5734,5734,5734,2020,97,346,97,214,2020,132,97,198,197,195,97,97,346,132,28,28,0,97,4,4,4,4,4,4,2,2,2,1,1,0,2023-12-22 14:20:00,0
5689,5692,5691,5691,2017,95,340,95,213,2017,127,95,200,196,194,95,95,340,127,28,28,13,95,4,4,4,4,4,4,2,2,2,4,4,0,2023-12-22 14:22:00,0
5708,5711,5708,5708,2012,84,379,84,215,2012,164,84,201,190,188,84,84,379,164,31,31,2,84,7,7,7,7,7,4,2,2,2,11,11,0,2023-12-22 14:24:00,0
5717,5717,5715,5715,2028,90,349,90,212,2028,137,90,211,198,192,90,90,349,137,28,28,0,90,4,4,4,4,4,12,2,2,2,13,13,0,2023-12-22 14:26:00,0
5734,5735,5735,5735,2026,82,362,82,205,2026,157,82,195,188,182,82,82,362,157,27,27,4,82,3,3,3,3,3,12,2,2,2,7,7,0,2023-12-22 14:28:00,0
5683,5685,5683,5683,2022,94,333,94,213,2022,120,94,195,191,187,94,94,333,120,28,28,0,94,4,4,4,4,3,8,2,2,2,4,4,1,2023-12-22 14:30:00,0
5724,5725,5725,5725,2023,102,372,102,224,2023,148,102,194,188,183,102,102,372,148,31,31,7,102,7,7,7,7,7,10,2,2,2,6,6,0,2023-12-22 14:32:00,0
5707,5706,5706,5706,2016,90,358,90,214,2016,144,90,200,191,182,90,90,358,144,28,28,17,90,4,4,4,4,3,18,2,2,2,9,9,1,2023-12-22 14:34:00,0
5724,5724,5724,5724,2027,85,361,85,217,2027,144,85,196,192,189,85,85,361,144,28,28,3,85,4,4,4,4,4,6,2,2,2,4,4,0,2023-12-22 14:36:00,0
5774,5774,5774,5774,2025,99,388,99,218,2025,170,99,188,183,182,99,99,388,170,28,28,5,99,4,4,4,4,4,2,2,2,2,5,5,0,2023-12-22 14:38:00,0
5725,5725,5725,5725,2023,87,356,87,208,2023,148,87,191,188,181,87,87,356,148,31,31,4,87,7,7,7,7,7,14,2,2,2,3,3,0,2023-12-22 14:40:00,0
5713,5714,5714,5714,2021,89,360,89,211,2021,149,89,197,192,189,89,89,360,149,28,28,0,89,4,4,4,4,4,6,2,2,2,5,5,0,2023-12-22 14:42:00,0
5678,5677,5677,5677,2023,97,338,97,208,2023,130,97,197,194,188,97,97,338,130,28,28,6,97,4,4,4,4,3,12,2,2,2,3,3,1,2023-12-22 14:44:00,0
5721,5722,5722,5722,2028,100,337,100,230,2028,107,100,193,191,185,100,100,337,107,31,31,1,100,7,7,7,7,7,12,2,2,2,2,2,0,2023-12-22 14:46:00,0
5683,5682,5682,5682,2019,95,342,95,213,2019,129,95,189,182,181,95,95,342,129,27,27,4,95,3,3,3,3,3,2,2,2,2,7,7,0,2023-12-22 14:48:00,0
5770,5770,5770,5770,2035,94,428,94,223,2035,205,94,202,196,194,94,94,428,154,29,29,14,94,5,5,4,4,3,4,2,2,2,6,6,1,2023-12-22 14:50:00,52
5169,5170,5170,5170,1950,36,287,36,159,1950,128,36,135,130,128,36,36,287,128,28,28,4,36,4,4,4,4,4,4,2,2,2,5,5,0,2023-12-22 14:52:00,0
5232,5232,5232,5232,2015,24,269,24,148,2015,121,24,130,120,118,24,24,269,121,31,31,6,24,7,7,7,7,7,4,2,2,2,10,10,0,2023-12-22 14:54:00,0
5262,5261,5261,5261,2025,24,279,24,145,2025,134,24,128,123,119,24,24,279,134,28,28,7,24,4,4,4,4,4,8,2,2,2,5,5,0,2023-12-22 14:56:00,0
5233,5234,5234,5234,2019,24,261,24,145,2019,116,24,131,122,118,24,24,261,116,28,28,18,24,4,4,4,4,4,8,2,2,2,9,9,0,2023-12-22 14:58:00,0
5266,5287,5266,5266,2021,24,299,24,148,2021,151,24,126,119,118,24,24,299,151,31,31,14,24,7,7,7,7,6,2,2,2,2,7,7,1,2023-12-22 15:00:00,0
5267,5268,5267,5267,2006,24,519,24,144,2006,375,24,135,123,118,24,24,519,375,28,28,19,24,4,4,4,4,4,10,2,2,2,12,12,0,2023-12-22 15:02:00,0
5269,5270,5269,5269,2026,24,286,24,144,2026,142,24,126,119,119,24,24,286,142,27,27,0,24,3,3,3,3,3,0,2,2,2,7,7,0,2023-12-22 15:04:00,0
5282,5281,5281,5281,2024,24,303,24,146,2024,157,24,129,120,118,24,24,303,157,28,28,6,24,4,4,4,4,3,4,2,2,2,9,9,1,2023-12-22 15:06:00,0
5269,5270,5270,5270,2023,24,294,24,149,2023,145,24,134,125,119,24,24,294,145,32,32,1,24,8,8,8,8,8,12,2,2,2,9,9,0,2023-12-22 15:08:00,0
5293,5295,5293,5293,2020,24,311,24,144,2020,167,24,136,125,118,24,24,311,167,27,27,1,24,3,3,3,3,3,14,2,2,2,11,11,0,2023-12-22 15:10:00,0
5303,5303,5303,5303,2029,24,318,24,145,2029,173,24,129,122,119,24,24,318,173,28,28,7,24,4,4,4,4,4,6,2,2,2,7,7,0,2023-12-22 15:12:00,0
5223,5222,5222,5222,2007,22,286,22,144,2007,142,22,128,120,117,22,22,286,142,28,28,3,22,4,4,4,4,4,6,2,2,2,8,8,0,2023-12-22 15:14:00,0
5308,5309,5309,5309,2035,24,313,24,149,2035,164,24,131,124,120,24,24,313,164,31,31,3,24,7,7,7,7,6,8,2,2,2,7,7,1,2023-12-22 15:16:00,0
5280,5280,5280,5280,2026,24,297,24,145,2026,152,24,130,123,118,24,24,297,152,28,28,0,24,4,4,4,4,4,10,2,2,2,7,7,0,2023-12-22 15:18:00,0
5282,5281,5281,5281,2027,24,301,24,145,2027,156,24,129,121,118,24,24,301,156,28,28,4,24,4,4,4,4,3,6,2,2,2,8,8,1,2023-12-22 15:20:00,0
5268,5269,5269,5269,2021,24,293,24,149,2021,144,24,128,123,120,24,24,293,144,31,31,12,24,7,7,7,7,7,6,2,2,2,5,5,0,2023-12-22 15:22:00,0
5284,5282,5282,5282,2021,24,312,24,144,2021,168,24,131,124,119,24,24,312,168,28,28,4,24,4,4,4,4,4,10,2,2,2,7,7,0,2023-12-22 15:24:00,0
5298,5300,5300,5300,2018,24,395,24,213,2018,182,24,134,121,118,24,24,395,182,95,95,3,24,37,3,3,3,3,6,2,2,2,13,13,0,2023-12-22 15:26:00,102
5308,5308,5308,5308,2033,24,314,24,145,2033,169,24,133,121,118,24,24,314,169,28,28,0,24,4,4,4,4,4,6,2,2,2,12,12,0,2023-12-22 15:28:00,0
5291,5291,5291,5291,2024,24,319,24,148,2024,171,24,129,120,118,24,24,319,171,31,31,10,24,7,7,7,7,7,4,2,2,2,9,9,0,2023-12-22 15:30:00,0
5263,5262,5262,5262,2018,24,297,24,145,2018,152,24,131,122,119,24,24,297,152,28,28,2,24,4,4,4,4,3,6,2,2,2,9,9,1,2023-12-22 15:32:00,0
5287,5288,5288,5288,2022,24,304,24,145,2022,159,24,136,123,120,24,24,304,159,28,28,4,24,4,4,4,4,4,6,2,2,2,13,13,0,2023-12-22 15:34:00,0
5318,5318,5318,5318,2037,24,311,24,149,2037,162,24,138,122,120,24,24,311,162,31,31,3,24,7,7,7,7,6,4,2,2,2,16,16,1,2023-12-22 15:36:00,0
5266,5266,5266,5266,2005,22,330,22,144,2005,186,22,138,123,117,22,22,330,186,28,28,8,22,4,4,4,4,4,12,2,2,2,15,15,0,2023-12-22 15:38:00,0
5303,5303,5303,5303,2025,24,316,24,145,2025,171,24,137,121,120,24,24,316,171,28,28,4,24,4,4,4,4,4,2,2,2,2,16,16,0,2023-12-22 15:40:00,0
5289,5288,5288,5288,2018,24,309,24,144,2018,165,24,141,126,118,24,24,309,165,27,27,2,24,3,3,3,3,3,16,2,2,2,15,15,0,2023-12-22 15:42:00,0
5302,5302,5302,5302,2020,24,329,24,149,2020,180,24,131,124,119,24,24,329,180,32,32,1,24,8,8,8,8,8,10,2,2,2,7,7,0,2023-12-22 15:44:00,0
5272,5272,5272,5272,2013,24,366,24,206,2013,160,24,141,121,118,24,24,366,160,89,89,2,24,3,3,3,3,3,6,2,2,2,20,20,0,2023-12-22 15:46:00,152
5263,5265,5263,5263,2016,24,322,24,168,2016,154,24,135,122,118,24,24,322,154,51,51,2,24,4,4,4,4,3,8,2,2,2,13,13,1,2023-12-22 15:48:00,46
5285,5286,5286,5286,2028,24,342,24,146,2028,196,24,138,120,118,24,24,342,145,29,29,5,24,5,5,4,4,4,4,2,2,2,18,18,0,2023-12-22 15:50:00,52
5263,5262,5262,5262,2028,24,281,24,148,2028,133,24,130,123,118,24,24,281,133,31,31,4,24,7,7,7,7,6,10,2,2,2,7,7,1,2023-12-22 15:52:00,0
5258,5258,5258,5258,2026,24,277,24,146,2026,131,24,128,122,119,24,24,277,131,28,28,0,24,4,4,4,4,4,6,2,2,2,6,6,0,2023-12-22 15:54:00,0
5306,5304,5304,5304,2037,24,299,24,145,2037,154,24,133,120,118,24,24,299,154,28,28,2,24,4,4,4,4,4,4,2,2,2,13,13,0,2023-12-22 15:56:00,0
5332,5333,5333,5333,2027,24,337,24,149,2027,188,24,143,123,119,24,24,337,188,31,31,2,24,7,7,7,7,7,8,2,2,2,20,20,0,2023-12-22 15:58:00,0
5309,5309,5309,5309,2022,24,326,24,145,2022,181,24,137,123,118,24,24,326,181,28,28,3,24,4,4,4,4,4,10,2,2,2,14,14,0,2023-12-22 16:00:00,0
5289,5291,5291,5291,1992,22,707,22,272,1992,435,22,132,121,118,22,22,707,435,156,156,8,22,68,3,3,3,3,6,2,2,2,11,11,0,2023-12-22 16:02:00,195
5290,5291,5289,5289,2020,24,387,24,218,2020,169,24,141,125,120,24,24,387,169,101,100,0,24,40,4,4,4,3,10,2,2,2,16,16,1,2023-12-22 16:04:00,110
5294,5294,5294,5294,2014,24,423,24,241,2014,182,24,136,123,118,24,24,423,182,124,125,2,24,54,7,7,7,7,10,2,2,2,13,13,0,2023-12-22 16:06:00,139
5277,5278,5278,5278,2013,24,324,24,144,2013,180,24,125,119,118,24,24,324,180,28,28,2,24,4,4,4,4,3,2,2,2,2,6,6,1,2023-12-22 16:08:00,0
5313,5313,5313,5313,2018,24,335,24,145,2018,190,24,144,125,119,24,24,335,190,28,28,5,24,4,4,4,4,4,12,2,2,2,19,19,0,2023-12-22 16:10:00,0
5314,5314,5314,5314,2027,30,333,25,148,2028,185,25,137,123,118,25,24,333,185,31,31,0,24,7,7,7,7,7,10,2,2,2,14,14,0,2023-12-22 16:12:00,2
5383,5383,5383,5383,2016,24,413,24,145,2016,268,24,141,124,118,24,24,413,268,28,28,6,24,4,4,4,4,3,12,2,2,2,17,17,1,2023-12-22 16:14:00,0
5460,5462,5460,5460,2017,24,469,24,146,2017,323,24,154,128,118,24,24,469,323,28,28,0,24,4,4,4,4,4,20,2,2,2,26,26,0,2023-12-22 16:16:00,2
5429,5430,5429,5429,2023,24,449,24,147,2023,302,24,139,125,119,24,24,449,302,30,30,4,24,5,4,4,4,3,12,2,2,2,14,14,1,2023-12-22 16:18:00,3
5457,5455,5455,5455,2017,24,465,24,148,2017,317,24,155,129,118,24,24,465,317,31,31,3,24,7,7,7,7,7,22,2,2,2,26,26,0,2023-12-22 16:20:00,0
5468,5469,5469,5469,2013,24,487,24,146,2013,341,24,151,121,119,24,24,487,341,29,29,0,24,4,4,4,4,4,4,2,2,2,30,30,0,2023-12-22 16:22:00,0
5374,5374,5372,5372,2003,23,424,23,144,2003,280,23,154,124,117,23,23,424,280,28,28,6,23,4,3,3,3,3,14,2,2,2,30,30,0,2023-12-22 16:24:00,3
5205,5208,5208,5208,2017,23,244,23,144,2017,100,23,126,123,120,23,23,244,100,28,28,8,23,4,4,4,4,4,6,2,2,2,3,3,0,2023-12-22 16:26:00,0
5233,5233,5233,5233,2030,24,245,24,148,2030,97,24,130,122,120,24,24,245,97,30,30,9,24,5,4,4,4,4,4,2,2,2,8,8,0,2023-12-22 16:28:00,3
5231,5231,5231,5231,2024,24,248,24,145,2024,103,24,132,121,118,24,24,248,103,28,28,2,24,4,4,4,4,3,6,2,2,2,11,11,1,2023-12-22 16:30:00,0
5246,5246,5246,5246,2029,24,266,24,149,2029,117,24,128,119,118,24,24,266,117,31,31,8,24,7,7,7,7,7,2,2,2,2,9,9,0,2023-12-22 16:32:00,0
5251,5251,5251,5251,2035,24,246,24,144,2035,102,24,132,120,119,24,24,246,102,27,27,8,24,3,3,3,3,3,2,2,2,2,12,12,0,2023-12-22 16:34:00,0
5226,5225,5225,5225,2018,24,257,24,145,2018,112,24,130,123,118,24,24,257,112,28,28,3,24,4,4,4,4,3,10,2,2,2,7,7,1,2023-12-22 16:36:00,0
5215,5215,5215,5215,2023,24,243,24,149,2023,94,24,131,122,119,24,24,243,94,32,32,5,24,8,8,8,8,8,6,2,2,2,9,9,0,2023-12-22 16:38:00,0
5276,5277,5277,5277,2035,24,279,24,145,2035,134,24,127,120,119,24,24,279,134,27,27,0,24,3,3,3,3,3,2,2,2,2,7,7,0,2023-12-22 16:40:00,0
5232,5231,5231,5231,2013,24,271,24,147,2013,124,24,132,121,119,24,24,271,124,30,30,9,24,5,4,4,4,4,4,2,2,2,11,11,0,2023-12-22 16:42:00,3
5256,5257,5256,5256,2023,24,282,24,145,2023,137,24,126,123,118,24,24,282,137,28,28,9,24,4,4,4,4,4,10,2,2,2,3,3,0,2023-12-22 16:44:00,0
5206,5207,5207,5207,2010,24,259,24,147,2010,112,24,133,121,118,24,24,259,112,31,31,7,24,7,7,7,7,6,6,2,2,2,12,12,1,2023-12-22 16:46:00,0
5233,5233,5233,5233,2025,24,354,24,145,2025,209,24,130,122,120,24,24,354,209,28,28,4,24,4,4,4,4,4,4,2,2,2,8,8,0,2023-12-22 16:48:00,0
5217,5236,5216,5216,2026,23,286,23,146,2026,140,23,126,121,120,23,23,286,89,28,28,1,23,4,4,3,3,3,2,2,2,2,5,5,0,2023-12-22 16:50:00,52
5240,5241,5241,5241,2026,23,360,23,151,2026,209,23,129,122,120,23,23,360,209,34,34,5,23,9,8,8,8,8,4,2,2,2,7,7,0,2023-12-22 16:52:00,3
5233,5232,5232,5232,2027,24,252,24,145,2027,107,24,128,118,118,24,24,252,107,27,27,8,24,3,3,3,3,3,0,2,2,2,10,10,0,2023-12-22 16:54:00,0
5226,5227,5227,5227,2029,24,241,24,145,2029,96,24,124,121,119,24,24,241,96,28,28,0,24,4,4,4,4,4,4,2,2,2,3,3,0,2023-12-22 16:56:00,0
5215,5215,5213,5213,2017,24,350,24,145,2017,205,24,129,119,117,24,24,350,205,28,28,0,24,4,4,4,4,4,4,2,2,2,10,10,0,2023-12-22 16:58:00,0
5276,5278,5278,5278,2029,24,284,24,148,2029,136,24,134,120,119,24,24,284,136,31,31,5,24,7,7,7,7,6,2,2,2,2,14,14,1,2023-12-22 17:00:00,0
5203,5203,5203,5203,2005,24,556,24,145,2005,411,24,132,121,117,24,24,556,411,28,28,4,24,4,4,4,4,4,8,2,2,2,11,11,0,2023-12-22 17:02:00,0
5244,5245,5243,5243,2024,24,259,24,145,2024,114,24,136,129,119,24,24,259,114,28,28,2,24,4,4,4,4,3,20,2,2,2,7,7,1,2023-12-22 17:04:00,0
5273,5274,5274,5274,2033,24,272,24,145,2033,127,24,134,121,118,24,24,272,127,27,27,0,24,3,3,3,3,3,6,2,2,2,13,13,0,2023-12-22 17:06:00,0
5244,5243,5243,5243,2021,24,273,24,151,2021,122,24,129,121,119,24,24,273,122,34,34,2,24,9,8,8,8,8,4,2,2,2,8,8,0,2023-12-22 17:08:00,3
5185,5186,5186,5186,2002,24,260,24,143,2002,117,24,126,119,117,24,24,260,117,27,27,0,24,3,3,3,3,3,4,2,2,2,7,7,0,2023-12-22 17:10:00,0
5236,5236,5236,5236,2034,24,237,24,146,2034,91,24,129,121,119,24,24,237,91,28,28,4,24,4,4,4,4,4,4,2,2,2,8,8,0,2023-12-22 17:12:00,0
5240,5260,5239,5239,2019,23,275,23,148,2019,127,23,125,120,118,23,23,275,127,31,31,5,23,7,7,7,7,7,4,2,2,2,5,5,0,2023-12-22 17:14:00,0
5231,5231,5230,5230,2023,24,252,24,145,2023,107,24,134,122,119,24,24,252,107,28,28,0,24,4,4,4,4,3,6,2,2,2,12,12,1,2023-12-22 17:16:00,0
5235,5236,5236,5236,2023,23,267,23,147,2023,120,23,128,119,117,23,23,267,120,30,30,14,23,5,4,4,4,4,4,2,2,2,9,9,0,2023-12-22 17:18:00,3
5259,5259,5259,5259,2020,24,281,24,149,2020,132,24,138,126,119,24,24,281,132,32,32,4,24,6,4,4,4,3,14,2,2,2,12,12,1,2023-12-22 17:20:00,6
5260,5261,5261,5261,2031,24,272,24,148,2031,124,24,132,119,118,24,24,272,124,31,31,2,24,7,7,7,7,7,2,2,2,2,13,13,0,2023-12-22 17:22:00,0
5252,5254,5252,5252,2033,24,250,24,146,2033,104,24,132,121,119,24,24,250,104,28,28,2,24,4,4,4,4,4,4,2,2,2,11,11,0,2023-12-22 17:24:00,0
5265,5265,5264,5264,2038,24,255,24,145,2038,110,24,132,124,120,24,24,255,110,27,27,4,24,3,3,3,3,3,8,2,2,2,8,8,0,2023-12-22 17:26:00,0
5243,5245,5244,5244,2023,24,260,24,145,2023,115,24,135,121,118,24,24,260,115,28,28,4,24,4,4,4,4,4,6,2,2,2,14,14,0,2023-12-22 17:28:00,0
5249,5248,5248,5248,2029,24,273,24,149,2029,124,24,123,118,118,24,24,273,124,31,31,5,24,7,7,7,7,7,0,2,2,2,5,5,0,2023-12-22 17:30:00,0
5281,5282,5282,5282,2025,24,296,24,145,2025,151,24,134,123,121,24,24,296,151,28,28,1,24,4,4,4,4,3,4,2,2,2,11,11,1,2023-12-22 17:32:00,0
5189,5189,5189,5189,2006,24,255,24,144,2006,111,24,131,120,117,24,24,255,111,28,28,1,24,4,4,4,4,4,6,2,2,2,11,11,0,2023-12-22 17:34:00,0
5234,5233,5233,5233,2032,24,243,24,149,2032,94,24,128,120,119,24,24,243,94,31,31,4,24,7,7,7,7,6,2,2,2,2,8,8,1,2023-12-22 17:36:00,0
5245,5246,5246,5246,2019,24,271,24,147,2019,124,24,134,122,119,24,24,271,124,30,30,0,24,5,4,4,4,4,6,2,2,2,12,12,0,2023-12-22 17:38:00,3
5297,5296,5296,5296,2027,24,304,24,145,2027,159,24,137,121,118,24,23,304,159,28,28,4,24,4,4,4,4,4,6,2,2,2,16,16,0,2023-12-22 17:40:00,0
5243,5242,5242,5242,2011,23,291,23,144,2011,147,23,133,122,118,23,24,291,147,27,27,0,23,3,3,3,3,3,8,2,2,2,11,11,0,2023-12-22 17:42:00,0
5228,5231,5230,5230,2016,24,270,24,148,2016,122,24,126,118,118,24,24,270,122,32,32,0,24,8,8,8,8,8,0,2,2,2,8,8,0,2023-12-22 17:44:00,0
5261,5261,5261,5261,2035,23,265,23,145,2035,120,23,129,119,119,23,23,265,120,27,27,7,23,3,3,3,3,3,0,2,2,2,10,10,0,2023-12-22 17:46:00,0
5238,5237,5237,5237,2026,24,257,24,145,2026,112,24,127,119,118,24,24,257,112,28,28,2,24,4,4,4,4,3,2,2,2,2,8,8,1,2023-12-22 17:48:00,0
5255,5257,5256,5256,2027,24,268,24,150,2027,118,24,137,124,120,24,24,268,118,32,32,1,24,8,8,8,8,8,8,2,2,2,13,13,0,2023-12-22 17:50:00,0
5236,5236,5236,5236,2019,24,271,24,143,2019,128,24,128,121,118,24,24,271,128,27,27,3,24,3,3,3,3,3,6,2,2,2,7,7,0,2023-12-22 17:52:00,0
5230,5229,5229,5229,2027,24,249,24,146,2027,103,24,126,122,118,24,24,249,103,28,28,0,24,4,4,4,4,3,8,2,2,2,4,4,1,2023-12-22 17:54:00,0
5224,5228,5224,5224,2022,24,248,24,145,2022,103,24,131,122,119,24,24,248,103,28,28,0,24,4,4,4,4,4,6,2,2,2,9,9,0,2023-12-22 17:56:00,0
5185,5186,5186,5186,1994,24,281,24,146,1994,135,24,131,120,117,24,24,281,135,31,31,4,24,7,7,7,7,6,6,2,2,2,11,11,1,2023-12-22 17:58:00,0
5231,5300,5228,5228,2013,24,278,24,145,2013,133,24,129,122,118,24,24,278,133,28,28,3,24,4,4,4,4,4,8,2,2,2,7,7,0,2023-12-22 18:00:00,0
5145,5148,5148,5148,1984,23,541,23,145,1984,396,23,127,119,118,23,23,541,396,28,28,0,23,4,4,4,4,4,2,2,2,2,8,8,0,2023-12-22 18:02:00,0
5253,5271,5252,5252,2025,24,278,24,145,2025,133,24,129,121,118,24,24,278,133,28,28,3,24,4,4,4,4,3,6,2,2,2,8,8,1,2023-12-22 18:04:00,0
5261,5263,5262,5262,2027,24,285,24,149,2027,136,24,127,122,118,24,24,285,136,31,31,5,24,7,7,7,7,7,8,2,2,2,5,5,0,2023-12-22 18:06:00,0
5246,5248,5246,5246,2023,23,262,23,144,2023,118,23,135,121,119,23,23,262,118,27,27,0,23,3,3,3,3,3,4,2,2,2,14,14,0,2023-12-22 18:08:00,0
5221,5220,5220,5220,2016,24,256,24,144,2016,112,24,133,121,117,24,24,256,112,28,28,0,24,4,4,4,4,3,8,2,2,2,12,12,1,2023-12-22 18:10:00,0
5212,5213,5213,5213,2021,24,238,24,146,2021,92,24,130,122,118,24,24,238,92,28,28,8,24,4,4,4,4,4,8,2,2,2,8,8,0,2023-12-22 18:12:00,0
5239,5239,5239,5239,2028,24,262,24,148,2028,114,24,125,119,119,24,24,262,114,31,31,0,24,7,7,7,7,7,0,2,2,2,6,6,0,2023-12-22 18:14:00,0
5236,5236,5236,5236,2026,24,256,24,145,2026,111,24,128,122,118,24,24,256,111,28,28,4,24,4,4,4,4,4,8,2,2,2,6,6,0,2023-12-22 18:16:00,0
5237,5236,5236,5236,2021,24,263,24,145,2021,118,24,131,122,118,24,24,263,118,28,28,0,24,4,4,4,4,4,8,2,2,2,9,9,0,2023-12-22 18:18:00,0
5167,5167,5167,5167,1998,24,246,24,144,1998,102,24,126,121,117,24,24,246,102,28,28,0,24,4,4,4,4,3,8,2,2,2,5,5,1,2023-12-22 18:20:00,0
5227,5227,5227,5227,2012,24,263,24,148,2012,115,24,139,123,119,24,24,263,115,31,31,4,24,7,7,7,7,7,8,2,2,2,16,16,0,2023-12-22 18:22:00,0
5228,5228,5228,5228,2021,24,255,24,144,2021,111,24,127,119,118,24,24,255,111,27,27,0,24,3,3,3,3,3,2,2,2,2,8,8,0,2023-12-22 18:24:00,0
5222,5221,5221,5221,2020,23,250,23,145,2020,105,23,131,122,119,23,23,250,105,28,28,5,23,4,4,4,4,3,6,2,2,2,9,9,1,2023-12-22 18:26:00,0
5252,5254,5253,5253,2033,24,258,24,145,2033,113,24,128,120,118,24,24,258,113,28,28,0,24,4,4,4,4,4,4,2,2,2,8,8,0,2023-12-22 18:28:00,0
5229,5229,5229,5229,2021,24,258,24,148,2021,110,24,132,119,119,24,24,258,110,31,31,8,24,7,7,7,7,7,0,2,2,2,13,13,0,2023-12-22 18:30:00,0
5214,5215,5215,5215,2031,24,222,24,146,2031,76,24,131,122,120,24,24,222,76,28,28,2,24,4,4,4,4,4,4,2,2,2,9,9,0,2023-12-22 18:32:00,0
5208,5209,5207,5207,2027,23,231,23,145,2027,86,23,126,120,118,23,23,231,86,28,28,11,23,4,4,4,4,4,4,2,2,2,6,6,0,2023-12-22 18:34:00,0
5232,5232,5232,5232,2033,24,241,24,148,2033,93,24,130,123,119,24,24,241,93,31,31,0,24,7,7,7,7,6,8,2,2,2,7,7,1,2023-12-22 18:36:00,0
5241,5242,5242,5242,2029,24,252,24,146,2029,106,24,129,123,118,24,24,252,106,28,28,4,24,4,4,4,4,4,10,2,2,2,6,6,0,2023-12-22 18:38:00,0
5225,5225,5225,5225,2017,24,243,24,144,2017,99,24,139,122,119,24,24,243,99,27,27,0,24,3,3,3,3,3,6,2,2,2,17,17,0,2023-12-22 18:40:00,0
5267,5266,5266,5266,2020,24,294,24,145,2020,149,24,139,126,118,24,24,294,149,28,28,0,24,4,4,4,4,3,16,2,2,2,13,13,1,2023-12-22 18:42:00,0
5240,5239,5239,5239,2016,24,285,24,148,2016,137,24,130,119,117,24,24,285,137,31,31,0,24,8,8,8,8,8,4,2,2,2,11,11,0,2023-12-22 18:44:00,0
5233,5234,5234,5234,2018,24,266,24,143,2018,123,24,127,118,118,24,24,266,123,27,27,0,24,3,3,3,3,3,0,2,2,2,9,9,0,2023-12-22 18:46:00,0
5294,5295,5295,5295,2037,24,288,24,146,2037,142,24,135,122,119,24,24,288,142,28,28,5,24,4,4,4,4,4,6,2,2,2,13,13,0,2023-12-22 18:48:00,0
5272,5270,5270,5270,2034,24,271,24,146,2034,125,24,131,121,120,24,24,271,125,28,28,0,24,4,4,4,4,4,2,2,2,2,10,10,0,2023-12-22 18:50:00,0
5261,5262,5262,5262,2026,24,282,24,149,2026,133,24,128,121,118,24,24,282,133,32,32,2,24,8,8,8,8,8,6,2,2,2,7,7,0,2023-12-22 18:52:00,0
5230,5271,5230,5230,2022,23,253,23,144,2022,109,23,133,122,119,23,23,253,109,27,27,0,23,3,3,3,3,3,6,2,2,2,11,11,0,2023-12-22 18:54:00,0
5223,5224,5224,5224,2019,24,252,24,145,2019,107,24,129,120,118,24,24,252,107,28,28,0,24,4,4,4,4,4,4,2,2,2,9,9,0,2023-12-22 18:56:00,0
5248,5248,5248,5248,2021,24,271,24,145,2021,126,24,133,122,118,24,24,271,126,28,28,2,24,4,4,4,4,4,8,2,2,2,11,11,0,2023-12-22 18:58:00,0
5237,5237,5236,5236,2017,23,274,23,148,2017,126,23,124,120,118,23,23,274,126,31,31,0,23,7,7,7,7,6,4,2,2,2,4,4,1,2023-12-22 19:00:00,0
5203,5201,5203,5203,2008,24,445,24,145,2008,300,24,136,123,118,24,24,445,300,28,28,2,24,4,4,4,4,4,10,2,2,2,13,13,0,2023-12-22 19:02:00,0
5231,5232,5232,5232,2017,24,263,24,145,2017,118,24,133,123,118,24,24,263,118,27,27,3,24,3,3,3,3,3,10,2,2,2,10,10,0,2023-12-22 19:04:00,2
5244,5243,5243,5243,2023,24,268,24,151,2023,117,24,133,123,118,24,24,268,117,34,34,0,24,7,4,4,4,3,10,2,2,2,10,10,1,2023-12-22 19:06:00,9
5196,5197,5197,5197,2004,24,337,24,221,2004,116,24,135,124,118,24,24,337,116,105,105,2,24,45,8,8,8,8,12,2,2,2,11,11,0,2023-12-22 19:08:00,109
5231,5231,5231,5231,2028,24,301,24,198,2028,103,24,128,123,119,24,24,301,103,81,81,0,24,30,3,3,3,3,8,2,2,2,5,5,0,2023-12-22 19:10:00,81
5230,5250,5229,5229,2024,24,247,24,146,2024,101,24,128,121,118,24,24,247,101,28,28,0,24,4,4,4,4,4,6,2,2,2,7,7,0,2023-12-22 19:12:00,0
5254,5254,5254,5254,2033,24,336,24,217,2033,119,24,128,122,118,24,24,336,119,100,100,0,24,40,4,4,4,4,8,2,2,2,6,6,0,2023-12-22 19:14:00,108
5211,5212,5212,5212,2016,24,249,24,148,2016,101,24,127,121,118,24,24,249,101,31,31,1,24,7,7,7,7,6,6,2,2,2,6,6,1,2023-12-22 19:16:00,0
5244,5264,5244,5244,2024,23,262,23,145,2024,117,23,133,121,118,23,23,262,117,28,28,4,23,4,4,4,4,4,6,2,2,2,12,12,0,2023-12-22 19:18:00,0
5242,5241,5241,5241,2015,24,281,24,145,2015,136,24,124,120,119,24,24,281,136,28,28,0,24,4,4,4,4,3,2,2,2,2,4,4,1,2023-12-22 19:20:00,0
5207,5207,5207,5207,2015,24,350,24,148,2015,202,24,128,123,119,24,24,350,202,31,31,0,24,7,7,7,7,7,8,2,2,2,5,5,0,2023-12-22 19:22:00,0
5246,5246,5246,5246,2027,23,259,23,145,2027,114,23,138,124,119,23,23,259,114,28,28,2,23,4,4,4,4,4,10,2,2,2,14,14,0,2023-12-22 19:24:00,0
5228,5229,5229,5229,2019,24,250,24,144,2019,106,24,132,122,118,24,24,250,106,27,27,0,24,3,3,3,3,3,8,2,2,2,10,10,0,2023-12-22 19:26:00,0
5246,5245,5245,5245,2029,24,258,24,145,2029,113,24,130,121,119,24,24,258,113,28,28,3,24,4,4,4,4,4,4,2,2,2,9,9,0,2023-12-22 19:28:00,0
5231,5232,5232,5232,2025,24,391,24,283,2025,108,24,127,119,118,24,24,391,108,165,165,1,24,74,7,7,7,7,2,2,2,2,8,8,0,2023-12-22 19:30:00,201
5214,5214,5214,5214,2018,24,272,24,150,2018,122,24,126,120,117,24,24,272,122,34,34,0,24,7,4,4,4,3,6,2,2,2,6,6,1,2023-12-22 19:32:00,9
5239,5238,5238,5238,2016,24,267,24,145,2016,122,24,135,124,119,24,24,267,122,28,28,4,24,4,4,4,4,4,10,2,2,2,11,11,0,2023-12-22 19:34:00,0
5214,5215,5215,5215,2023,24,240,24,145,2023,95,24,128,122,119,24,24,240,95,28,28,0,24,4,4,4,4,3,6,2,2,2,6,6,1,2023-12-22 19:36:00,0
5259,5259,5259,5259,2037,24,256,24,149,2037,107,24,132,124,120,24,24,256,107,31,31,0,24,7,7,7,7,7,8,2,2,2,8,8,0,2023-12-22 19:38:00,0
5260,5258,5258,5258,2030,24,314,24,193,2030,121,24,132,121,118,24,24,314,121,75,75,4,24,27,4,4,4,4,6,2,2,2,11,11,0,2023-12-22 19:40:00,71
5252,5254,5254,5254,2016,24,335,24,196,2016,139,24,131,123,119,24,24,335,139,79,79,0,24,29,3,3,3,3,8,2,2,2,8,8,0,2023-12-22 19:42:00,78
5277,5276,5276,5276,2035,23,454,23,328,2035,126,23,136,124,119,23,23,454,126,210,210,0,23,95,4,4,4,4,10,2,2,2,12,12,0,2023-12-22 19:44:00,273
5257,5257,5257,5257,2020,24,288,24,148,2020,140,24,129,121,118,24,24,288,140,31,31,0,24,7,7,7,7,7,6,2,2,2,8,8,0,2023-12-22 19:46:00,0
5212,5232,5213,5213,2018,24,245,24,145,2018,100,24,129,120,118,24,24,245,100,28,28,1,24,4,4,4,4,3,4,2,2,2,9,9,1,2023-12-22 19:48:00,0
5271,5270,5270,5270,2042,23,255,23,146,2042,109,23,130,121,119,23,23,255,109,28,28,4,23,4,4,4,4,4,4,2,2,2,9,9,0,2023-12-22 19:50:00,0
5256,5256,5256,5256,2026,24,372,24,145,2026,227,24,132,122,118,24,24,372,227,28,28,0,24,4,4,4,4,4,8,2,2,2,10,10,0,2023-12-22 19:52:00,0
5237,5237,5238,5238,2022,24,264,24,148,2022,116,24,133,123,118,24,24,264,116,31,31,2,24,7,7,7,7,7,10,2,2,2,10,10,0,2023-12-22 19:54:00,0
5178,5179,5178,5178,2002,24,250,24,144,2002,106,24,125,119,117,24,24,250,106,28,28,0,24,4,4,4,4,4,4,2,2,2,6,6,0,2023-12-22 19:56:00,0
5256,5255,5255,5255,2022,24,380,24,145,2022,235,24,129,124,119,24,24,380,235,28,28,0,24,4,4,4,4,4,10,2,2,2,5,5,0,2023-12-22 19:58:00,0
5263,5264,5264,5264,2025,24,277,24,145,2025,132,24,132,125,119,24,24,277,132,28,28,4,24,4,4,4,4,3,12,2,2,2,7,7,1,2023-12-22 20:00:00,0
5228,5227,5228,5228,2011,24,378,24,148,2011,230,24,130,122,119,24,24,378,230,31,31,0,24,7,7,7,7,7,6,2,2,2,8,8,0,2023-12-22 20:02:00,0
5252,5252,5252,5252,2026,24,266,24,144,2026,122,24,131,122,118,24,24,266,122,27,27,3,24,3,3,3,3,3,8,2,2,2,9,9,0,2023-12-22 20:04:00,0
5251,5251,5251,5251,2027,24,263,24,145,2027,118,24,133,120,118,24,24,263,118,28,28,1,24,4,4,4,4,3,4,2,2,2,13,13,1,2023-12-22 20:06:00,0
5262,5260,5260,5260,2029,24,272,24,149,2029,123,24,129,124,119,24,24,272,123,31,31,0,24,7,7,7,7,7,10,2,2,2,5,5,0,2023-12-22 20:08:00,0
5259,5260,5260,5260,2019,23,280,23,144,2019,136,23,138,122,118,23,23,280,136,28,28,4,23,4,4,4,4,4,8,2,2,2,16,16,0,2023-12-22 20:10:00,0
5220,5220,5220,5220,2019,24,258,24,145,2019,113,24,126,122,118,24,24,258,113,28,28,0,24,4,4,4,4,4,8,2,2,2,4,4,0,2023-12-22 20:12:00,0
5253,5252,5252,5252,2027,24,262,24,146,2027,116,24,131,119,119,24,24,262,116,28,28,0,24,4,4,4,4,4,0,2,2,2,12,12,0,2023-12-22 20:14:00,0
5243,5245,5245,5245,2033,23,257,23,148,2033,109,23,126,120,118,23,23,257,109,31,31,4,23,7,7,7,7,6,4,2,2,2,6,6,1,2023-12-22 20:16:00,0
5196,5196,5196,5196,2015,24,238,24,145,2015,93,24,130,120,118,24,24,238,93,28,28,0,24,4,4,4,4,4,4,2,2,2,10,10,0,2023-12-22 20:18:00,0
5233,5233,5233,5233,2024,24,251,24,144,2024,107,24,132,121,118,24,24,251,107,27,27,4,24,3,3,3,3,3,6,2,2,2,11,11,0,2023-12-22 20:20:00,0
5198,5199,5198,5198,2007,24,359,24,145,2007,214,24,126,119,118,24,24,359,214,28,28,0,24,4,4,4,4,3,2,2,2,2,7,7,1,2023-12-22 20:22:00,0
5254,5254,5254,5254,2025,24,267,24,149,2025,118,24,135,123,118,24,24,267,118,32,32,0,24,8,8,8,8,8,10,2,2,2,12,12,0,2023-12-22 20:24:00,0
5236,5236,5236,5236,2029,24,249,24,144,2029,105,24,128,120,118,24,24,249,105,27,27,4,24,3,3,3,3,3,4,2,2,2,8,8,0,2023-12-22 20:26:00,0
5245,5244,5244,5244,2029,24,256,24,146,2029,110,24,130,121,118,24,24,256,110,28,28,0,24,4,4,4,4,4,6,2,2,2,9,9,0,2023-12-22 20:28:00,0
5252,5253,5253,5253,2032,24,252,24,145,2032,107,24,134,122,119,24,24,252,107,28,28,2,24,4,4,4,4,4,6,2,2,2,12,12,0,2023-12-22 20:30:00,0
5219,5219,5219,5219,2014,24,259,24,148,2014,111,24,132,121,118,24,24,259,111,31,31,0,24,7,7,7,7,6,6,2,2,2,11,11,1,2023-12-22 20:32:00,0
5249,5248,5248,5248,2022,23,268,23,145,2022,123,23,135,122,118,23,23,268,123,28,28,0,23,4,4,4,4,4,8,2,2,2,13,13,0,2023-12-22 20:34:00,0
5248,5271,5249,5249,2022,24,267,24,145,2022,122,24,134,123,119,24,24,267,122,28,28,4,24,4,4,4,4,3,8,2,2,2,11,11,1,2023-12-22 20:36:00,0
5236,5236,5236,5236,2021,24,263,24,144,2021,119,24,127,122,118,24,24,263,119,27,27,0,24,3,3,3,3,3,8,2,2,2,5,5,0,2023-12-22 20:38:00,0
5236,5236,5236,5236,2028,24,253,24,150,2028,103,24,126,120,118,24,24,253,103,32,32,0,24,8,8,8,8,8,4,2,2,2,6,6,0,2023-12-22 20:40:00,0
5211,5211,5211,5211,2006,23,379,23,143,2006,236,23,128,125,119,23,23,379,236,27,27,2,23,3,3,3,3,3,12,2,2,2,3,3,0,2023-12-22 20:42:00,0
5294,5294,5294,5294,2035,24,293,24,146,2035,147,24,131,123,120,24,24,293,147,28,28,0,24,4,4,4,4,4,6,2,2,2,8,8,0,2023-12-22 20:44:00,0
5253,5252,5252,5252,2030,24,260,24,145,2030,115,24,132,120,118,24,24,260,115,28,28,4,24,4,4,4,4,4,4,2,2,2,12,12,0,2023-12-22 20:46:00,0
5264,5265,5265,5265,2030,24,274,24,149,2030,125,24,130,120,118,24,24,274,125,31,31,0,24,7,7,7,7,6,4,2,2,2,10,10,1,2023-12-22 20:48:00,0
5233,5232,5232,5232,2028,24,245,24,145,2028,100,24,130,121,119,24,24,245,100,28,28,0,24,4,4,4,4,4,4,2,2,2,9,9,0,2023-12-22 20:50:00,0
5295,5296,5296,5296,2024,24,310,24,145,2024,165,24,136,121,118,24,24,310,165,28,28,2,24,4,4,4,4,4,6,2,2,2,15,15,0,2023-12-22 20:52:00,0
5206,5206,5206,5206,2015,24,249,24,148,2015,101,24,126,120,119,24,24,249,101,31,31,0,24,7,7,7,7,7,2,2,2,2,6,6,0,2023-12-22 20:54:00,0
5265,5264,5264,5264,2037,24,260,24,146,2037,114,24,130,121,118,24,24,260,114,28,28,0,24,4,4,4,4,4,6,2,2,2,9,9,0,2023-12-22 20:56:00,0
5260,5261,5261,5261,2036,24,259,24,145,2036,114,24,132,120,120,24,24,259,114,28,28,0,24,4,4,4,4,4,0,2,2,2,12,12,0,2023-12-22 20:58:00,0
5261,5261,5261,5261,2029,23,267,23,146,2029,121,23,137,121,119,23,23,267,121,28,28,0,23,4,4,4,4,3,4,2,2,2,16,16,1,2023-12-22 21:00:00,0
5248,5247,5247,5247,2013,24,688,24,148,2013,540,24,132,124,118,24,24,688,540,31,31,5,24,7,7,7,7,7,12,2,2,2,8,8,0,2023-12-22 21:02:00,0
5218,5219,5219,5219,2015,24,270,24,143,2015,127,24,126,119,118,24,24,270,127,27,27,0,24,3,3,3,3,3,2,2,2,2,7,7,0,2023-12-22 21:04:00,0
5242,5241,5241,5241,2019,24,270,24,145,2019,125,24,134,120,117,24,24,270,125,28,28,0,24,4,4,4,4,3,6,2,2,2,14,14,1,2023-12-22 21:06:00,0
5251,5250,5250,5250,2028,23,261,23,145,2028,116,23,130,120,119,23,23,261,116,28,28,4,23,4,4,4,4,4,2,2,2,2,10,10,0,2023-12-22 21:08:00,0
5252,5254,5254,5254,2031,24,262,24,149,2031,113,24,131,121,118,24,24,262,113,31,31,0,24,7,7,7,7,7,6,2,2,2,10,10,0,2023-12-22 21:10:00,0
5276,5275,5275,5275,2026,24,286,24,145,2026,141,24,133,121,118,24,24,286,141,28,28,2,24,4,4,4,4,4,6,2,2,2,12,12,0,2023-12-22 21:12:00,0
5226,5226,5226,5226,2022,24,256,24,145,2022,111,24,124,121,118,24,24,256,111,28,28,0,24,4,4,4,4,4,6,2,2,2,3,3,0,2023-12-22 21:14:00,0
5223,5223,5223,5223,2020,24,246,24,145,2020,101,24,132,123,120,24,24,246,101,28,28,1,24,4,4,4,4,3,6,2,2,2,9,9,1,2023-12-22 21:16:00,0
5251,5251,5251,5251,2028,24,367,24,149,2028,218,24,131,122,118,24,24,367,218,31,31,4,24,7,7,7,7,7,8,2,2,2,9,9,0,2023-12-22 21:18:00,0
5228,5229,5228,5228,2025,24,248,24,144,2025,104,24,129,120,119,24,24,248,104,27,27,0,24,3,3,3,3,3,2,2,2,2,9,9,0,2023-12-22 21:20:00,0
5208,5206,5206,5206,2010,24,254,24,144,2010,110,24,130,122,118,24,24,254,110,28,28,4,24,4,4,4,4,3,8,2,2,2,8,8,1,2023-12-22 21:22:00,0
5214,5215,5215,5215,2020,23,250,23,149,2020,101,23,124,119,118,23,23,250,101,32,32,0,23,8,8,8,8,8,2,2,2,2,5,5,0,2023-12-22 21:24:00,0
5227,5229,5229,5229,2014,24,268,24,144,2014,124,24,129,120,118,24,24,268,124,27,27,0,24,3,3,3,3,3,4,2,2,2,9,9,0,2023-12-22 21:26:00,0
5164,5164,5164,5164,2004,24,237,24,143,2004,94,24,123,117,117,24,24,237,94,27,27,2,24,4,4,4,4,4,0,2,2,2,6,6,0,2023-12-22 21:28:00,0
5224,5224,5224,5224,2023,24,247,24,145,2023,102,24,128,119,119,24,24,247,102,28,28,0,24,4,4,4,4,4,0,2,2,2,9,9,0,2023-12-22 21:30:00,0
5252,5253,5252,5252,2022,23,273,23,148,2022,125,23,132,121,119,23,23,273,125,31,31,0,23,7,7,7,7,6,4,2,2,2,11,11,1,2023-12-22 21:32:00,0
5250,5249,5249,5249,2025,24,265,24,145,2025,120,24,130,122,118,24,24,265,120,28,28,0,24,4,4,4,4,4,8,2,2,2,8,8,0,2023-12-22 21:34:00,0
5238,5238,5238,5238,2029,24,253,24,145,2029,108,24,122,119,118,24,24,253,108,27,27,1,24,3,3,3,3,3,2,2,2,2,3,3,0,2023-12-22 21:36:00,0
5282,5282,5282,5282,2042,24,374,24,146,2042,228,24,128,121,119,24,24,374,228,28,28,0,24,4,4,4,4,3,4,2,2,2,7,7,1,2023-12-22 21:38:00,0
5245,5245,5245,5245,2037,24,253,24,151,2037,102,24,124,121,118,24,24,253,102,33,33,0,24,8,8,8,8,8,6,2,2,2,3,3,0,2023-12-22 21:40:00,0
5249,5249,5249,5249,2022,24,370,24,144,2022,226,24,129,121,119,24,24,370,226,27,27,1,24,3,3,3,3,3,4,2,2,2,8,8,0,2023-12-22 21:42:00,0
5244,5245,5245,5245,2024,24,271,24,145,2024,126,24,129,122,118,24,24,271,126,28,28,1,24,4,4,4,4,4,8,2,2,2,7,7,0,2023-12-22 21:44:00,0
5258,5258,5258,5258,2027,24,271,24,145,2027,126,24,128,120,118,24,24,271,126,28,28,0,24,4,4,4,4,4,4,2,2,2,8,8,0,2023-12-22 21:46:00,0
5221,5221,5221,5221,2018,24,249,24,148,2018,101,24,133,120,118,24,24,249,101,31,31,4,24,7,7,7,7,6,4,2,2,2,13,13,1,2023-12-22 21:48:00,0
5240,5240,5240,5240,2023,24,260,24,145,2023,115,24,129,120,119,24,24,260,115,28,28,2,24,4,4,4,4,4,2,2,2,2,9,9,0,2023-12-22 21:50:00,0
5215,5215,5215,5215,2015,23,264,23,144,2015,120,23,128,121,118,23,23,264,120,27,27,0,23,4,4,4,4,4,6,2,2,2,7,7,0,2023-12-22 21:52:00,0
5232,5232,5232,5232,2017,24,263,24,145,2017,118,24,130,122,118,24,24,263,118,28,28,4,24,4,4,4,4,4,8,2,2,2,8,8,0,2023-12-22 21:54:00,0
5208,5208,5208,5208,2019,24,267,24,147,2019,120,24,132,120,119,24,24,267,120,31,31,0,24,7,7,7,7,7,2,2,2,2,12,12,0,2023-12-22 21:56:00,1
5121,5121,5121,5121,2020,23,264,23,145,2020,119,23,132,122,118,23,23,264,119,28,28,2,23,4,4,4,4,4,8,2,2,2,10,10,0,2023-12-22 21:58:00,0
5139,5139,5139,5139,2028,24,267,24,146,2028,121,24,135,121,119,24,24,267,121,28,28,0,24,4,4,4,4,3,4,2,2,2,14,14,1,2023-12-22 22:00:00,0
5108,5130,5108,5108,2009,24,573,24,148,2009,425,24,132,120,117,24,24,573,425,31,31,0,24,7,7,7,7,7,6,2,2,2,12,12,0,2023-12-22 22:02:00,0
5146,5146,5146,5146,2039,24,355,24,144,2039,211,24,129,123,120,24,24,355,211,27,27,4,24,3,3,3,3,3,6,2,2,2,6,6,0,2023-12-22 22:04:00,0
5116,5114,5114,5114,2019,24,258,24,145,2019,113,24,136,123,118,24,24,258,113,28,28,0,24,4,4,4,4,3,10,2,2,2,13,13,1,2023-12-22 22:06:00,0
5111,5113,5113,5113,2025,24,249,24,146,2025,103,24,129,121,118,24,24,249,103,28,28,4,24,4,4,4,4,4,6,2,2,2,8,8,0,2023-12-22 22:08:00,0
5136,5137,5136,5136,2034,24,251,24,148,2034,103,24,137,128,119,24,24,251,103,31,31,0,24,7,7,7,7,7,18,2,2,2,9,9,0,2023-12-22 22:10:00,0
5134,5133,5133,5133,2035,24,357,24,146,2035,211,24,125,121,118,24,24,357,211,28,28,0,24,4,4,4,4,4,6,2,2,2,4,4,0,2023-12-22 22:12:00,0
5110,5109,5109,5109,2019,23,269,23,145,2019,124,23,128,120,118,23,23,269,124,28,28,2,23,4,4,4,4,4,4,2,2,2,8,8,0,2023-12-22 22:14:00,0
5119,5121,5121,5121,2022,24,260,24,145,2022,115,24,129,121,119,24,24,260,115,28,28,0,24,4,4,4,4,3,4,2,2,2,8,8,1,2023-12-22 22:16:00,0
5136,5135,5135,5135,2035,24,257,24,149,2035,108,24,131,124,119,24,24,257,108,31,31,0,24,7,7,7,7,7,10,2,2,2,7,7,0,2023-12-22 22:18:00,0
5138,5139,5139,5139,2034,24,261,24,145,2034,116,24,127,119,118,24,24,261,116,27,27,2,24,3,3,3,3,3,2,2,2,2,8,8,0,2023-12-22 22:20:00,0
5089,5089,5089,5089,2019,24,340,24,145,2019,195,24,131,122,119,24,24,340,195,28,28,0,24,4,4,4,4,3,6,2,2,2,9,9,1,2023-12-22 22:22:00,0
5119,5118,5118,5118,2028,24,250,24,145,2028,105,24,130,121,119,24,24,250,105,28,28,4,24,4,4,4,4,4,4,2,2,2,9,9,0,2023-12-22 22:24:00,0
5119,5139,5120,5120,2029,23,256,23,148,2029,108,23,127,118,118,23,23,256,108,31,31,0,23,7,7,7,7,7,0,2,2,2,9,9,0,2023-12-22 22:26:00,0
5134,5133,5133,5133,2026,24,266,24,146,2026,120,24,129,125,119,24,24,266,120,28,28,0,24,4,4,4,4,4,12,2,2,2,4,4,0,2023-12-22 22:28:00,0
5104,5105,5105,5105,2023,24,241,24,145,2023,96,24,133,122,118,24,24,241,96,28,28,4,24,4,4,4,4,4,8,2,2,2,11,11,0,2023-12-22 22:30:00,0
5129,5129,5129,5129,2035,24,247,24,145,2035,102,24,132,122,119,24,24,247,102,28,28,0,24,4,4,4,4,3,6,2,2,2,10,10,1,2023-12-22 22:32:00,0
5168,5168,5168,5168,2031,24,288,24,149,2031,139,24,138,121,118,24,24,288,139,31,31,2,24,7,7,7,7,7,6,2,2,2,17,17,0,2023-12-22 22:34:00,0
5111,5111,5111,5111,2019,24,267,24,144,2019,123,24,132,125,118,24,24,267,123,27,27,2,24,3,3,3,3,3,14,2,2,2,7,7,0,2023-12-22 22:36:00,0
5139,5138,5138,5138,2030,24,271,24,145,2030,126,24,129,121,120,24,24,271,126,28,28,0,24,4,4,4,4,3,2,2,2,2,8,8,1,2023-12-22 22:38:00,0
5086,5087,5087,5087,2021,24,229,24,145,2021,84,24,126,121,118,24,24,229,84,28,28,2,24,4,4,4,4,4,6,2,2,2,5,5,0,2023-12-22 22:40:00,0
5103,5103,5103,5103,2017,23,262,23,149,2017,113,23,128,119,118,23,23,262,113,31,31,0,23,7,7,7,7,7,2,2,2,2,9,9,0,2023-12-22 22:42:00,0
5127,5128,5127,5127,2021,24,266,24,145,2021,121,24,133,121,119,24,24,266,121,28,28,2,24,4,4,4,4,4,4,2,2,2,12,12,0,2023-12-22 22:44:00,0
5128,5128,5128,5128,2020,24,278,24,144,2020,134,24,131,124,119,24,24,278,134,28,28,0,24,4,4,4,4,4,10,2,2,2,7,7,0,2023-12-22 22:46:00,0
5119,5118,5118,5118,2024,24,263,24,149,2024,114,24,126,122,118,24,24,263,114,31,31,0,24,7,7,7,7,6,8,2,2,2,4,4,1,2023-12-22 22:48:00,0
5141,5142,5142,5142,2020,24,290,24,145,2020,145,24,124,120,118,24,24,290,145,28,28,2,24,4,4,4,4,4,4,2,2,2,4,4,0,2023-12-22 22:50:00,0
5128,5128,5128,5128,2029,23,353,23,145,2029,208,23,134,123,120,23,23,353,208,28,28,0,23,4,4,4,4,4,6,2,2,2,11,11,0,2023-12-22 22:52:00,0
5120,5120,5120,5120,2031,24,246,24,146,2031,100,24,130,121,118,24,24,246,100,28,28,0,24,4,4,4,4,4,6,2,2,2,9,9,0,2023-12-22 22:54:00,0
5135,5153,5134,5134,2031,24,264,24,148,2031,116,24,128,122,118,24,24,264,116,31,31,0,24,7,7,7,7,7,8,2,2,2,6,6,0,2023-12-22 22:56:00,0
5144,5145,5145,5145,2032,24,268,24,145,2032,123,24,134,124,119,24,24,268,123,28,28,0,24,4,4,4,4,4,10,2,2,2,10,10,0,2023-12-22 22:58:00,0
5081,5080,5080,5080,2005,24,256,24,144,2005,112,24,130,122,118,24,24,256,112,27,27,3,24,3,3,3,3,3,8,2,2,2,8,8,0,2023-12-22 23:00:00,0
5103,5104,5104,5104,2017,24,256,24,145,2017,111,24,129,122,118,24,24,256,111,28,28,0,24,4,4,4,4,3,8,2,2,2,7,7,1,2023-12-22 23:02:00,0
5089,5088,5088,5088,2018,24,246,24,148,2018,98,24,127,121,119,24,24,246,98,31,31,0,24,7,7,7,7,7,4,2,2,2,6,6,0,2023-12-22 23:04:00,0
5137,5137,5137,5137,2023,23,272,23,145,2023,127,23,133,124,120,23,23,272,127,28,28,0,23,4,4,4,4,3,8,2,2,2,9,9,1,2023-12-22 23:06:00,0
5143,5143,5143,5143,2036,24,267,24,146,2036,121,24,125,122,118,24,24,267,121,28,28,0,24,4,4,4,4,4,8,2,2,2,3,3,0,2023-12-22 23:08:00,0
5113,5114,5114,5114,2030,24,240,24,145,2030,95,24,128,122,120,24,24,240,95,28,28,5,24,4,4,4,4,4,4,2,2,2,6,6,0,2023-12-22 23:10:00,0
5122,5121,5121,5121,2025,24,357,24,149,2025,208,24,135,123,119,24,24,357,208,31,31,0,24,7,7,7,7,7,8,2,2,2,12,12,0,2023-12-22 23:12:00,0
5096,5097,5097,5097,2017,24,249,24,144,2017,105,24,128,121,118,24,24,249,105,28,28,0,24,4,4,4,4,4,6,2,2,2,7,7,0,2023-12-22 23:14:00,0
5125,5125,5125,5125,2032,24,248,24,146,2032,102,24,131,124,119,24,24,248,102,28,28,4,24,4,4,4,4,3,10,2,2,2,7,7,1,2023-12-22 23:16:00,0
5167,5167,5167,5167,2040,24,368,24,145,2040,223,24,137,123,120,24,24,368,223,27,27,0,24,3,3,3,3,3,6,2,2,2,14,14,0,2023-12-22 23:18:00,0
5151,5151,5151,5151,2039,23,273,23,149,2039,124,23,125,120,119,23,23,273,124,31,31,4,23,7,7,7,7,7,2,2,2,2,5,5,0,2023-12-22 23:20:00,0
5112,5112,5112,5112,2014,24,377,24,145,2014,232,24,131,119,117,24,24,377,232,28,28,0,24,4,4,4,4,3,4,2,2,2,12,12,1,2023-12-22 23:22:00,0
5105,5103,5103,5103,2026,24,243,24,146,2026,97,24,127,119,118,24,24,243,97,28,28,0,24,4,4,4,4,4,2,2,2,2,8,8,0,2023-12-22 23:24:00,0
5135,5137,5137,5137,2026,24,273,24,148,2026,125,24,130,125,120,24,24,273,125,31,31,0,24,7,7,7,7,7,10,2,2,2,5,5,0,2023-12-22 23:26:00,0
5128,5128,5128,5128,2026,24,268,24,145,2026,123,24,127,120,118,24,24,268,123,28,28,0,24,4,4,4,4,4,4,2,2,2,7,7,0,2023-12-22 23:28:00,0
5141,5141,5141,5141,2031,24,268,24,146,2031,122,24,130,124,119,24,24,268,122,28,28,5,24,4,4,4,4,4,10,2,2,2,6,6,0,2023-12-22 23:30:00,0
5111,5111,5111,5111,2022,24,251,24,145,2022,106,24,126,120,118,24,24,251,106,28,28,0,24,4,4,4,4,3,4,2,2,2,6,6,1,2023-12-22 23:32:00,0
5132,5131,5131,5131,2030,23,264,23,148,2030,116,23,135,126,120,23,23,264,116,31,31,0,23,7,7,7,7,7,12,2,2,2,9,9,0,2023-12-22 23:34:00,0
5139,5139,5139,5139,2024,24,282,24,144,2024,138,24,126,120,118,24,24,282,138,27,27,4,24,3,3,3,3,3,4,2,2,2,6,6,0,2023-12-22 23:36:00,0
5146,5147,5147,5147,2033,24,365,24,146,2033,219,24,130,120,119,24,24,365,219,28,28,0,24,4,4,4,4,3,2,2,2,2,10,10,1,2023-12-22 23:38:00,0
5131,5131,5131,5131,2025,24,266,24,145,2025,121,24,133,121,120,24,24,266,121,28,28,0,24,4,4,4,4,4,2,2,2,2,12,12,0,2023-12-22 23:40:00,0
5149,5148,5148,5148,2029,24,380,24,149,2029,231,24,133,122,119,24,24,380,231,31,31,2,24,7,7,7,7,7,6,2,2,2,11,11,0,2023-12-22 23:42:00,0
5109,5109,5109,5109,2021,24,244,24,145,2021,99,24,138,129,121,24,24,244,99,28,28,0,24,4,4,4,4,4,16,2,2,2,9,9,0,2023-12-22 23:44:00,0
5129,5130,5130,5130,2026,23,270,23,145,2026,125,23,135,122,118,23,23,270,125,28,28,2,23,4,4,4,4,4,8,2,2,2,13,13,0,2023-12-22 23:46:00,0
5124,5123,5123,5123,2031,24,349,24,146,2031,203,24,130,121,119,24,24,349,203,28,28,0,24,4,4,4,4,3,4,2,2,2,9,9,1,2023-12-22 23:48:00,0
5121,5141,5121,5121,2028,24,301,24,149,2028,152,24,136,126,119,24,24,301,101,32,32,0,24,8,8,7,7,7,14,2,2,2,10,10,0,2023-12-22 23:50:00,52
5110,5110,5110,5110,2014,24,265,24,144,2014,121,24,130,122,118,24,24,265,121,27,27,4,24,3,3,3,3,3,8,2,2,2,8,8,0,2023-12-22 23:52:00,0
5136,5137,5137,5137,2026,24,268,24,145,2026,123,24,134,120,119,24,24,268,123,28,28,0,24,4,4,4,4,3,2,2,2,2,14,14,1,2023-12-22 23:54:00,0
5125,5123,5123,5123,2021,24,266,24,145,2021,121,24,130,122,118,24,24,266,121,28,28,4,24,4,4,4,4,4,8,2,2,2,8,8,0,2023-12-22 23:56:00,0
5102,5103,5103,5103,2014,24,263,24,147,2014,116,24,128,121,120,24,24,263,116,31,31,0,24,7,7,7,7,6,2,2,2,2,7,7,1,2023-12-22 23:58:00,0
5156,5156,5156,5156,2027,23,286,23,146,2027,140,23,129,122,119,23,23,286,140,28,28,0,23,4,4,4,4,4,6,2,2,2,7,7,0,2023-12-23 00:00:00,0
5111,5111,5111,5111,2011,24,668,24,145,2011,523,24,141,123,118,24,24,668,523,28,28,0,24,4,4,4,4,4,10,2,2,2,18,18,0,2023-12-23 00:02:00,0
5109,5108,5108,5108,2020,24,255,24,148,2020,107,24,130,119,118,24,24,255,107,31,31,0,24,7,7,7,7,7,2,2,2,2,11,11,0,2023-12-23 00:04:00,0
5112,5114,5114,5114,2029,24,249,24,145,2029,104,24,126,119,118,24,24,249,104,28,28,2,24,4,4,4,4,4,2,2,2,2,7,7,0,2023-12-23 00:06:00,0
5101,5100,5100,5100,2013,24,268,24,142,2013,126,24,130,122,118,24,24,268,126,26,26,1,24,3,3,3,3,3,8,2,2,2,8,8,0,2023-12-23 00:08:00,0
5113,5113,5113,5113,2025,23,258,23,146,2025,112,23,125,119,119,23,23,258,112,29,29,0,23,4,4,4,4,3,0,2,2,2,6,6,1,2023-12-23 00:10:00,0
5119,5119,5119,5119,2021,24,261,24,148,2021,113,24,132,122,119,24,24,261,113,31,31,2,24,7,7,7,7,7,6,2,2,2,10,10,0,2023-12-23 00:12:00,0
5131,5132,5132,5132,2019,24,280,24,145,2019,135,24,133,124,118,24,24,280,135,28,28,0,24,4,4,4,4,3,12,2,2,2,9,9,1,2023-12-23 00:14:00,0
5141,5140,5140,5140,2022,24,280,24,145,2022,135,24,133,121,118,24,24,280,135,28,28,0,24,4,4,4,4,4,6,2,2,2,12,12,0,2023-12-23 00:16:00,0
5119,5120,5120,5120,2020,24,360,24,145,2020,215,24,131,120,119,24,24,360,215,28,28,2,24,4,4,4,4,4,2,2,2,2,11,11,0,2023-12-23 00:18:00,0
5127,5127,5127,5127,2025,24,268,24,149,2025,119,24,128,119,118,24,24,268,119,31,31,0,24,7,7,7,7,7,2,2,2,2,9,9,0,2023-12-23 00:20:00,0
5150,5150,5150,5150,2029,24,277,24,145,2029,132,24,131,124,119,24,24,277,132,28,28,0,24,4,4,4,4,4,10,2,2,2,7,7,0,2023-12-23 00:22:00,0
5126,5125,5125,5125,2029,24,249,24,145,2029,104,24,132,122,118,24,24,249,104,27,27,0,24,3,3,3,3,3,8,2,2,2,10,10,0,2023-12-23 00:24:00,0
5142,5143,5143,5143,2032,23,264,23,145,2032,119,23,134,121,118,23,23,264,119,28,28,0,23,4,4,4,4,3,6,2,2,2,13,13,1,2023-12-23 00:26:00,0
5100,5099,5099,5099,2025,24,350,24,148,2025,202,24,126,121,118,24,24,350,202,31,31,5,24,7,7,7,7,7,6,2,2,2,5,5,0,2023-12-23 00:28:00,0
5132,5134,5133,5133,2030,24,258,24,146,2030,112,24,130,122,119,24,24,258,112,28,28,0,24,4,4,4,4,3,6,2,2,2,8,8,1,2023-12-23 00:30:00,0
5098,5098,5098,5098,2014,24,263,24,143,2014,120,24,132,119,117,24,24,263,120,27,27,2,24,4,4,4,4,4,4,2,2,2,13,13,0,2023-12-23 00:32:00,0
5124,5122,5122,5122,2025,24,260,24,145,2025,115,24,129,121,120,24,24,260,115,28,28,0,24,4,4,4,4,4,2,2,2,2,8,8,0,2023-12-23 00:34:00,0
5123,5124,5124,5124,2030,24,252,24,149,2030,103,24,133,124,120,24,24,252,103,31,31,0,24,7,7,7,7,7,8,2,2,2,9,9,0,2023-12-23 00:36:00,0
5090,5091,5091,5091,2015,23,253,23,144,2015,109,23,123,118,118,23,23,253,109,28,28,2,23,4,4,4,4,4,0,2,2,2,5,5,0,2023-12-23 00:38:00,0
5117,5117,5117,5117,2026,24,255,24,146,2026,109,24,130,121,119,24,24,255,109,28,28,0,24,4,4,4,4,3,4,2,2,2,9,9,1,2023-12-23 00:40:00,0
5094,5094,5094,5094,2023,24,237,24,144,2023,93,24,128,123,118,24,24,237,93,27,27,0,24,3,3,3,3,3,10,2,2,2,5,5,0,2023-12-23 00:42:00,0
5092,5091,5091,5091,2015,24,261,24,147,2015,114,24,125,118,118,24,24,261,114,31,31,2,24,7,7,7,7,7,0,2,2,2,7,7,0,2023-12-23 00:44:00,0
5149,5150,5150,5150,2029,24,281,24,146,2029,135,24,131,120,118,24,24,281,135,28,28,0,24,4,4,4,4,3,4,2,2,2,11,11,1,2023-12-23 00:46:00,0
5139,5138,5138,5138,2029,24,366,24,145,2029,221,24,135,124,118,24,24,366,221,28,28,2,24,4,4,4,4,4,12,2,2,2,11,11,0,2023-12-23 00:48:00,0
5129,5130,5130,5130,2020,24,281,24,149,2020,132,24,130,119,118,24,24,281,132,32,32,0,24,8,8,8,8,8,2,2,2,2,11,11,0,2023-12-23 00:50:00,0
5111,5111,5111,5111,2023,23,256,23,144,2023,112,23,127,119,119,23,23,256,112,27,27,0,23,3,3,3,3,3,0,2,2,2,8,8,0,2023-12-23 00:52:00,0
5121,5121,5121,5121,2032,24,245,24,145,2032,100,24,129,123,118,24,24,245,100,28,28,2,24,4,4,4,4,3,10,2,2,2,6,6,1,2023-12-23 00:54:00,0
5108,5108,5108,5108,2011,24,281,24,145,2011,136,24,129,124,119,24,24,281,136,28,28,0,24,4,4,4,4,4,10,2,2,2,5,5,0,2023-12-23 00:56:00,0
5113,5112,5112,5112,2026,24,257,24,148,2026,109,24,129,122,119,24,24,257,109,31,31,4,24,7,7,7,7,6,6,2,2,2,7,7,1,2023-12-23 00:58:00,0
5125,5126,5126,5126,2028,24,257,24,145,2028,112,24,128,121,118,24,24,257,112,28,28,0,24,4,4,4,4,4,6,2,2,2,7,7,0,2023-12-23 01:00:00,0
5137,5137,5137,5137,2003,24,507,24,145,2003,362,24,138,122,118,24,24,507,362,28,28,0,24,4,4,4,4,4,8,2,2,2,16,16,0,2023-12-23 01:02:00,0
5119,5118,5118,5118,2020,23,367,23,144,2020,223,23,132,120,118,23,23,367,223,27,27,4,23,3,3,3,3,3,4,2,2,2,12,12,0,2023-12-23 01:04:00,0
5124,5125,5125,5125,2018,24,279,24,149,2018,130,24,129,121,119,24,24,279,130,32,32,0,24,8,8,8,8,8,4,2,2,2,8,8,0,2023-12-23 01:06:00,0
5127,5127,5127,5127,2033,24,249,24,144,2033,105,24,131,119,118,24,24,249,105,27,27,0,24,3,3,3,3,3,2,2,2,2,12,12,0,2023-12-23 01:08:00,0
5115,5114,5114,5114,2026,24,262,24,153,2026,109,24,129,119,118,24,24,262,109,36,36,0,24,4,4,4,4,3,2,2,2,2,10,10,1,2023-12-23 01:10:00,20
5129,5129,5129,5129,2024,24,265,24,145,2024,120,24,131,123,121,24,24,265,120,28,28,1,24,4,4,4,4,3,4,2,2,2,8,8,1,2023-12-23 01:12:00,0
5123,5143,5124,5124,2030,24,250,24,149,2030,101,24,135,120,118,24,24,250,101,31,31,2,24,7,7,7,7,7,4,2,2,2,15,15,0,2023-12-23 01:14:00,0
5104,5103,5103,5103,2014,23,257,23,145,2014,112,23,134,123,118,23,23,257,112,28,28,0,23,4,4,4,4,4,10,2,2,2,11,11,0,2023-12-23 01:16:00,0
5107,5108,5108,5108,2025,24,247,24,144,2025,103,24,127,120,118,24,24,247,103,27,27,0,24,3,3,3,3,3,4,2,2,2,7,7,0,2023-12-23 01:18:00,0
5071,5071,5071,5071,2006,24,251,24,144,2006,107,24,128,119,117,24,24,251,107,28,28,0,24,4,4,4,4,4,4,2,2,2,9,9,0,2023-12-23 01:20:00,0
5125,5125,5125,5125,2028,24,268,24,149,2028,119,24,126,119,118,24,24,268,119,31,31,0,24,7,7,7,7,7,2,2,2,2,7,7,0,2023-12-23 01:22:00,0
5103,5105,5103,5103,2021,24,250,24,145,2021,105,24,122,118,118,24,24,250,105,28,28,5,24,4,4,4,4,3,0,2,2,2,4,4,1,2023-12-23 01:24:00,0
5166,5165,5164,5164,2027,24,295,24,145,2027,150,24,135,122,119,24,24,295,150,28,28,0,24,4,4,4,4,4,6,2,2,2,13,13,0,2023-12-23 01:26:00,0
5101,5102,5102,5102,2018,24,265,24,148,2018,117,24,123,120,118,24,24,265,117,31,31,0,24,7,7,7,7,6,4,2,2,2,3,3,1,2023-12-23 01:28:00,0
5139,5139,5139,5139,2033,23,264,23,146,2033,118,23,128,122,119,23,23,264,118,28,28,2,23,4,4,4,4,4,6,2,2,2,6,6,0,2023-12-23 01:30:00,0
5114,5115,5115,5115,2025,24,255,24,145,2025,110,24,127,119,118,24,24,255,110,28,28,0,24,4,4,4,4,4,2,2,2,2,8,8,0,2023-12-23 01:32:00,0
5096,5095,5095,5095,2020,24,247,24,143,2020,104,24,125,121,118,24,24,247,104,27,27,2,24,3,3,3,3,3,6,2,2,2,4,4,0,2023-12-23 01:34:00,0
5134,5134,5134,5134,2031,24,258,24,150,2031,108,24,135,124,119,24,24,258,108,32,32,0,24,8,8,8,8,8,10,2,2,2,11,11,0,2023-12-23 01:36:00,0
5084,5085,5085,5085,2015,24,241,24,143,2015,98,24,125,120,118,24,24,241,98,27,27,0,24,3,3,3,3,3,4,2,2,2,5,5,0,2023-12-23 01:38:00,0
5136,5136,5136,5136,2036,24,255,24,146,2036,109,24,128,120,119,24,24,255,109,28,28,2,24,4,4,4,4,3,2,2,2,2,8,8,1,2023-12-23 01:40:00,0
5046,5045,5045,5045,1997,23,247,23,144,1997,103,23,128,122,117,23,23,247,103,28,28,0,23,4,4,4,4,4,10,2,2,2,6,6,0,2023-12-23 01:42:00,0
5083,5084,5084,5084,2020,24,235,24,148,2020,87,24,129,120,118,24,24,235,87,31,31,0,24,7,7,7,7,6,4,2,2,2,9,9,1,2023-12-23 01:44:00,0
5162,5160,5160,5160,2037,24,283,24,146,2037,137,24,127,122,119,24,24,283,137,28,28,5,24,4,4,4,4,4,6,2,2,2,5,5,0,2023-12-23 01:46:00,0
5180,5182,5182,5182,2039,24,288,24,146,2039,142,24,135,123,120,24,24,288,142,28,28,0,24,4,4,4,4,4,6,2,2,2,12,12,0,2023-12-23 01:48:00,0
5130,5130,5130,5130,2021,24,315,24,145,2021,170,24,139,126,119,24,24,315,119,28,28,0,24,4,4,3,3,3,14,2,2,2,13,13,0,2023-12-23 01:50:00,52
5158,5177,5158,5158,2032,24,386,24,149,2032,237,24,134,124,118,24,24,386,237,31,31,0,24,7,7,7,7,7,12,2,2,2,10,10,0,2023-12-23 01:52:00,0
5148,5148,5148,5148,2041,24,247,24,146,2041,101,24,137,124,119,24,24,247,101,28,28,1,24,4,4,4,4,3,10,2,2,2,13,13,1,2023-12-23 01:54:00,0
5139,5138,5139,5139,2030,24,265,24,145,2030,120,24,129,122,119,24,24,265,120,28,28,0,24,4,4,4,4,4,6,2,2,2,7,7,0,2023-12-23 01:56:00,0
5121,5120,5119,5119,2019,23,272,23,148,2019,124,23,133,123,117,23,23,272,124,31,31,0,23,7,7,7,7,6,12,2,2,2,10,10,1,2023-12-23 01:58:00,0
5115,5116,5116,5116,2019,24,264,24,145,2019,119,24,132,122,118,24,24,264,119,28,28,2,24,4,4,4,4,4,8,2,2,2,10,10,0,2023-12-23 02:00:00,0
5127,5128,5128,5128,2009,24,592,24,144,2009,448,24,132,122,118,24,24,592,448,28,28,0,24,4,4,4,4,4,8,2,2,2,10,10,0,2023-12-23 02:02:00,0
5106,5106,5106,5106,2015,24,368,24,144,2015,224,24,128,121,119,24,24,368,224,27,27,0,24,3,3,3,3,3,4,2,2,2,7,7,0,2023-12-23 02:04:00,0
5067,5066,5066,5066,2015,23,240,23,149,2015,91,23,126,122,117,23,23,240,91,32,32,4,23,8,8,8,8,8,10,2,2,2,4,4,0,2023-12-23 02:06:00,0
5127,5128,5128,5128,2037,24,241,24,144,2037,97,24,130,122,120,24,24,241,97,27,27,0,24,3,3,3,3,3,4,2,2,2,8,8,0,2023-12-23 02:08:00,0
5131,5131,5131,5131,2035,24,250,24,146,2035,104,24,132,122,118,24,24,250,104,28,28,3,24,4,4,4,4,3,8,2,2,2,10,10,1,2023-12-23 02:10:00,0
5105,5103,5103,5103,2018,24,259,24,148,2018,111,24,131,121,118,24,24,259,111,31,31,1,24,7,7,7,7,7,6,2,2,2,10,10,0,2023-12-23 02:12:00,0
5143,5145,5145,5145,2019,24,294,24,145,2019,149,24,129,121,118,24,24,294,149,28,28,0,24,4,4,4,4,3,6,2,2,2,8,8,1,2023-12-23 02:14:00,0
5116,5115,5115,5115,2013,24,274,24,144,2013,130,24,131,123,119,24,24,274,130,28,28,4,24,4,4,4,4,4,8,2,2,2,8,8,0,2023-12-23 02:16:00,0
5130,5130,5130,5130,2030,24,258,24,146,2030,112,24,131,121,119,24,24,258,112,28,28,0,24,4,4,4,4,4,4,2,2,2,10,10,0,2023-12-23 02:18:00,0
5140,5141,5141,5141,2026,24,274,24,148,2026,126,24,134,122,119,24,24,274,126,31,31,0,24,7,7,7,7,7,6,2,2,2,12,12,0,2023-12-23 02:20:00,0
5106,5126,5106,5106,2021,24,253,24,145,2021,108,24,130,121,119,24,24,253,108,28,28,2,24,4,4,4,4,4,4,2,2,2,9,9,0,2023-12-23 02:22:00,0
5130,5130,5130,5130,2018,23,286,23,145,2018,141,23,127,121,117,23,23,286,141,28,28,0,23,4,4,4,4,3,8,2,2,2,6,6,1,2023-12-23 02:24:00,0
5114,5113,5113,5113,2016,24,269,24,144,2016,125,24,134,120,118,24,24,269,125,27,27,4,24,3,3,3,3,3,4,2,2,2,14,14,0,2023-12-23 02:26:00,0
5148,5149,5149,5149,2035,24,267,24,149,2035,118,24,130,123,119,24,24,267,118,31,31,0,24,7,7,7,7,7,8,2,2,2,7,7,0,2023-12-23 02:28:00,0
5132,5130,5130,5130,2031,24,263,24,145,2031,118,24,127,121,118,24,24,263,118,28,28,0,24,4,4,4,4,3,6,2,2,2,6,6,1,2023-12-23 02:30:00,0
5079,5081,5081,5081,2017,23,239,23,145,2017,94,23,128,123,118,23,23,239,94,28,28,4,23,4,4,4,4,4,10,2,2,2,5,5,0,2023-12-23 02:32:00,0
5142,5141,5141,5141,2032,24,271,24,148,2032,123,24,131,124,118,24,24,271,123,31,31,0,24,7,7,7,7,7,12,2,2,2,7,7,0,2023-12-23 02:34:00,0
5124,5125,5125,5125,2026,24,264,24,145,2026,119,24,130,123,118,24,24,264,119,28,28,0,24,4,4,4,4,4,10,2,2,2,7,7,0,2023-12-23 02:36:00,0
5126,5126,5126,5126,2019,24,373,24,145,2019,228,24,131,118,118,24,24,373,228,28,28,0,24,4,4,4,4,4,0,2,2,2,13,13,0,2023-12-23 02:38:00,0
5158,5158,5158,5158,2036,24,272,24,146,2036,126,24,133,122,119,24,24,272,126,28,28,1,24,4,4,4,4,3,6,2,2,2,11,11,1,2023-12-23 02:40:00,0
5116,5116,5116,5116,2014,24,278,24,148,2014,130,24,129,118,117,24,24,278,130,31,31,4,24,7,7,7,7,7,2,2,2,2,11,11,0,2023-12-23 02:42:00,0
5105,5103,5103,5103,2023,24,244,24,144,2023,100,24,132,124,118,24,24,244,100,27,27,0,24,3,3,3,3,3,12,2,2,2,8,8,0,2023-12-23 02:44:00,0
5115,5117,5117,5117,2016,24,270,24,145,2016,125,24,128,120,118,24,24,270,125,28,28,0,24,4,4,4,4,3,4,2,2,2,8,8,1,2023-12-23 02:46:00,0
5102,5101,5101,5101,2019,24,253,24,145,2019,108,24,127,120,118,24,24,253,108,28,28,0,24,4,4,4,4,4,4,2,2,2,7,7,0,2023-12-23 02:48:00,0
5069,5069,5069,5069,1999,23,326,23,148,1999,178,23,125,120,117,23,23,326,127,32,32,0,23,8,8,7,7,7,6,2,2,2,5,5,0,2023-12-23 02:50:00,52
5110,5111,5111,5111,2020,24,256,24,144,2020,112,24,128,120,118,24,24,256,112,28,28,5,24,4,4,4,4,4,4,2,2,2,8,8,0,2023-12-23 02:52:00,0
5135,5135,5135,5135,2028,24,263,24,146,2028,117,24,133,122,119,24,24,263,117,28,28,0,24,4,4,4,4,4,6,2,2,2,11,11,0,2023-12-23 02:54:00,0
6200,6200,6200,6200,2434,29,359,29,176,2434,183,29,164,148,142,29,29,359,183,36,36,8,29,7,7,7,7,7,12,3,3,3,16,16,0,2023-12-23 02:56:00,0
5090,5089,5089,5089,2014,23,258,23,143,2014,115,23,129,118,118,23,23,258,115,27,27,2,23,4,4,4,4,4,0,2,2,2,11,11,0,2023-12-23 02:58:00,0
5115,5116,5116,5116,2023,24,258,24,144,2023,114,24,129,122,119,24,24,258,114,27,27,0,24,3,3,3,3,3,6,2,2,2,7,7,0,2023-12-23 03:00:00,0
5194,5193,5193,5193,2021,24,427,24,146,2021,281,24,142,126,118,24,24,427,281,28,28,2,24,4,4,4,4,3,16,2,2,2,16,16,1,2023-12-23 03:02:00,0
5142,5142,5142,5142,2020,24,390,24,148,2020,242,24,133,121,118,24,24,390,242,31,31,0,24,7,7,7,7,7,6,2,2,2,12,12,0,2023-12-23 03:04:00,0
5107,5107,5107,5107,2020,24,256,24,144,2020,112,24,125,119,118,24,24,256,112,28,28,0,24,4,4,4,4,3,2,2,2,2,6,6,1,2023-12-23 03:06:00,0
5123,5124,5124,5124,2024,24,269,24,146,2024,123,24,124,120,119,24,24,269,123,28,28,2,24,4,4,4,4,4,2,2,2,2,4,4,0,2023-12-23 03:08:00,0
5162,5161,5161,5161,2037,24,277,24,149,2037,128,24,134,123,119,24,24,277,128,31,31,0,24,7,7,7,7,7,8,2,2,2,11,11,0,2023-12-23 03:10:00,0
5229,5230,5230,5230,2034,24,441,24,145,2034,296,24,139,123,119,24,24,441,296,28,28,3,24,4,4,4,4,4,8,2,2,2,16,16,0,2023-12-23 03:12:00,0
5124,5124,5124,5124,2027,24,257,24,146,2027,111,24,126,120,119,24,24,257,111,28,28,1,24,4,4,4,4,4,2,2,2,2,6,6,0,2023-12-23 03:14:00,0
5125,5145,5125,5125,2026,23,265,23,146,2026,119,23,131,121,118,23,23,265,119,29,29,0,23,4,4,4,4,3,6,2,2,2,10,10,1,2023-12-23 03:16:00,0
5141,5140,5140,5140,2017,24,288,24,147,2017,141,24,140,121,119,24,24,288,141,31,31,4,24,7,7,7,7,7,4,2,2,2,19,19,0,2023-12-23 03:18:00,0
5139,5140,5140,5140,2021,24,278,24,145,2021,133,24,131,120,118,24,24,278,133,28,28,0,24,4,4,4,4,4,4,2,2,2,11,11,0,2023-12-23 03:20:00,0
5092,5092,5092,5092,2000,23,283,23,142,2000,141,23,132,118,118,23,23,283,141,26,26,0,23,3,3,3,3,3,0,2,2,2,14,14,0,2023-12-23 03:22:00,0
5114,5114,5114,5114,2027,24,248,24,146,2027,102,24,127,122,119,24,24,248,102,28,28,0,24,4,4,4,4,4,6,2,2,2,5,5,0,2023-12-23 03:24:00,0
5109,5109,5109,5109,2022,24,258,24,148,2022,110,24,131,120,119,24,24,258,110,31,31,0,24,7,7,7,7,7,2,2,2,2,11,11,0,2023-12-23 03:26:00,0
5114,5112,5112,5112,2030,24,244,24,145,2030,99,24,129,121,120,24,24,244,99,28,28,5,24,4,4,4,4,3,2,2,2,2,8,8,1,2023-12-23 03:28:00,0
5119,5121,5121,5121,2025,24,257,24,145,2025,112,24,126,121,118,24,24,257,112,28,28,0,24,4,4,4,4,4,6,2,2,2,5,5,0,2023-12-23 03:30:00,0
5113,5113,5113,5113,2022,24,261,24,148,2022,113,24,131,123,120,24,24,261,113,31,31,0,24,7,7,7,7,6,6,2,2,2,8,8,1,2023-12-23 03:32:00,0
5106,5106,5106,5106,2020,24,252,24,145,2020,107,24,131,120,118,24,24,252,107,28,28,4,24,4,4,4,4,4,4,2,2,2,11,11,0,2023-12-23 03:34:00,0
5132,5132,5132,5132,2030,24,263,24,145,2030,118,24,129,123,119,24,24,263,118,28,28,0,24,4,4,4,4,4,8,2,2,2,6,6,0,2023-12-23 03:36:00,0
5120,5120,5120,5120,2026,24,354,24,144,2026,210,24,131,120,118,24,24,354,210,27,27,4,24,3,3,3,3,3,4,2,2,2,11,11,0,2023-12-23 03:38:00,0
5130,5130,5130,5130,2032,24,263,24,150,2032,113,24,128,121,118,24,24,263,113,32,32,0,24,8,8,8,8,8,6,2,2,2,7,7,0,2023-12-23 03:40:00,0
5127,5147,5127,5127,2024,23,368,23,144,2024,224,23,131,123,118,23,23,368,224,27,27,0,23,3,3,3,3,3,10,2,2,2,8,8,0,2023-12-23 03:42:00,0
5161,5159,5159,5159,2038,24,262,24,146,2038,116,24,138,125,120,24,24,262,116,28,28,2,24,4,4,4,4,3,10,2,2,2,13,13,1,2023-12-23 03:44:00,0
5064,5066,5066,5066,2012,24,239,24,145,2012,94,24,124,118,117,24,24,239,94,28,28,0,24,4,4,4,4,4,2,2,2,2,6,6,0,2023-12-23 03:46:00,0
5141,5140,5140,5140,2029,23,273,23,148,2029,125,23,131,122,118,23,23,273,125,31,31,0,23,7,7,7,7,6,8,2,2,2,9,9,1,2023-12-23 03:48:00,0
5129,5129,5129,5129,2016,24,281,24,145,2016,136,24,131,124,119,24,24,281,136,28,28,4,24,4,4,4,4,4,10,2,2,2,7,7,0,2023-12-23 03:50:00,0
5123,5123,5123,5123,2023,24,266,24,144,2023,122,24,131,121,119,24,24,266,122,28,28,0,24,4,4,4,4,4,4,2,2,2,10,10,0,2023-12-23 03:52:00,0
5113,5135,5114,5114,2024,24,261,24,148,2024,113,24,125,120,119,24,24,261,113,31,31,0,24,7,7,7,7,7,2,2,2,2,5,5,0,2023-12-23 03:54:00,0
5104,5101,5101,5101,2022,24,252,24,145,2022,107,24,128,120,118,24,24,252,107,28,28,0,24,4,4,4,4,4,4,2,2,2,8,8,0,2023-12-23 03:56:00,0
5160,5163,5163,5163,2023,24,290,24,145,2023,145,24,140,124,119,24,24,290,145,28,28,0,24,4,4,4,4,4,10,2,2,2,16,16,0,2023-12-23 03:58:00,0
5115,5115,5115,5115,2024,24,257,24,146,2024,111,24,128,121,119,24,24,257,111,28,28,3,24,4,4,4,4,3,4,2,2,2,7,7,1,2023-12-23 04:00:00,0
5132,5132,5132,5132,2013,24,593,24,147,2013,446,24,132,123,118,24,24,593,446,31,31,0,24,7,7,7,7,7,10,2,2,2,9,9,0,2023-12-23 04:02:00,0
5152,5151,5151,5151,2034,24,369,24,145,2034,224,24,130,120,118,24,24,369,224,27,27,4,24,3,3,3,3,3,4,2,2,2,10,10,0,2023-12-23 04:04:00,0
5123,5124,5124,5124,2021,24,268,24,145,2021,123,24,130,121,119,24,24,268,123,28,28,0,24,4,4,4,4,3,4,2,2,2,9,9,1,2023-12-23 04:06:00,0
5108,5107,5107,5107,2028,23,247,23,150,2028,97,23,129,120,118,23,23,247,97,32,32,0,23,8,8,8,8,8,4,2,2,2,9,9,0,2023-12-23 04:08:00,0
5065,5066,5066,5066,2001,24,244,24,142,2001,102,24,139,120,117,24,24,244,102,27,27,2,24,3,3,3,3,3,6,2,2,2,19,19,0,2023-12-23 04:10:00,0
5113,5113,5113,5113,2025,23,349,23,146,2025,203,23,133,121,119,23,23,349,203,28,28,0,23,4,4,4,4,4,4,2,2,2,12,12,0,2023-12-23 04:12:00,0
5123,5123,5123,5123,2028,24,259,24,145,2028,114,24,128,120,119,24,24,259,114,28,28,2,24,4,4,4,4,4,2,2,2,2,8,8,0,2023-12-23 04:14:00,0
5130,5129,5129,5129,2018,24,283,24,148,2018,135,24,131,124,118,24,24,283,135,31,31,2,24,7,7,7,7,6,12,2,2,2,7,7,1,2023-12-23 04:16:00,0
5111,5112,5112,5112,2021,24,255,24,145,2021,110,24,130,124,118,24,24,255,110,28,28,0,24,4,4,4,4,4,12,2,2,2,6,6,0,2023-12-23 04:18:00,0
5112,5112,5112,5112,2015,24,266,24,144,2015,122,24,130,124,119,24,24,266,122,28,28,2,24,4,4,4,4,3,10,2,2,2,6,6,1,2023-12-23 04:20:00,0
5130,5129,5130,5130,2014,24,280,24,145,2014,135,24,134,127,118,24,24,280,135,27,27,0,24,3,3,3,3,3,18,2,2,2,7,7,0,2023-12-23 04:22:00,0
5147,5148,5147,5147,2030,24,276,24,149,2030,127,24,134,126,119,24,24,276,127,32,32,0,24,8,8,8,8,8,14,2,2,2,8,8,0,2023-12-23 04:24:00,0
5139,5139,5139,5139,2028,24,272,24,144,2028,128,24,126,121,119,24,24,272,128,27,27,4,24,3,3,3,3,3,4,2,2,2,5,5,0,2023-12-23 04:26:00,0
5118,5118,5118,5118,2021,24,265,24,145,2021,120,24,130,122,118,24,24,265,120,28,28,0,24,4,4,4,4,4,8,2,2,2,8,8,0,2023-12-23 04:28:00,0
5137,5138,5137,5137,2030,24,271,24,149,2030,122,24,127,122,119,24,24,271,122,31,31,4,24,7,7,7,7,7,6,2,2,2,5,5,0,2023-12-23 04:30:00,0
5121,5121,5121,5121,2032,24,251,24,145,2032,106,24,128,118,118,24,24,251,106,28,28,0,24,4,4,4,4,3,0,2,2,2,10,10,1,2023-12-23 04:32:00,0
5064,5064,5064,5064,2009,23,242,23,144,2009,98,23,126,122,117,23,23,242,98,28,28,0,23,4,4,4,4,4,10,2,2,2,4,4,0,2023-12-23 04:34:00,0
5118,5116,5116,5116,2034,24,237,24,146,2034,91,24,134,122,119,24,24,237,91,28,28,4,24,4,4,4,4,3,6,2,2,2,12,12,1,2023-12-23 04:36:00,0
5116,5118,5118,5118,2021,23,261,23,148,2021,113,23,133,122,120,23,23,261,113,31,31,0,23,7,7,7,7,7,4,2,2,2,11,11,0,2023-12-23 04:38:00,0
5136,5135,5135,5135,2032,24,267,24,145,2032,122,24,125,118,118,24,24,267,122,28,28,4,24,4,4,4,4,4,0,2,2,2,7,7,0,2023-12-23 04:40:00,0
5106,5107,5107,5107,2019,24,360,24,145,2019,215,24,125,118,118,24,24,360,215,27,27,0,24,3,3,3,3,3,0,2,2,2,7,7,0,2023-12-23 04:42:00,0
5126,5126,5126,5126,2025,24,264,24,145,2025,119,24,131,121,118,24,24,264,119,28,28,0,24,4,4,4,4,4,6,2,2,2,10,10,0,2023-12-23 04:44:00,0
5129,5129,5129,5129,2024,24,278,24,148,2024,130,24,127,121,118,24,24,278,130,31,31,2,24,7,7,7,7,7,6,2,2,2,6,6,0,2023-12-23 04:46:00,0
5134,5133,5133,5133,2038,24,352,24,145,2038,207,24,127,119,119,24,24,352,207,28,28,0,24,4,4,4,4,3,0,2,2,2,8,8,1,2023-12-23 04:48:00,0
5155,5156,5156,5156,2031,24,277,24,146,2031,131,24,135,122,118,24,24,277,131,28,28,0,24,4,4,4,4,4,8,2,2,2,13,13,0,2023-12-23 04:50:00,0
5418,5417,5417,5417,2021,66,416,66,186,2021,230,66,176,166,164,66,66,416,230,32,32,4,66,8,8,8,8,8,4,2,2,2,10,10,0,2023-12-23 04:52:00,0
5593,5593,5593,5593,2035,92,327,92,214,2035,113,92,203,191,187,92,92,327,113,27,27,0,92,3,3,3,3,3,8,2,2,2,12,12,0,2023-12-23 04:54:00,0
5579,5580,5580,5580,2034,98,314,98,211,2034,103,98,190,185,183,98,98,314,103,28,28,2,98,4,4,4,4,4,4,2,2,2,5,5,0,2023-12-23 04:56:00,0
5506,5505,5505,5505,2006,86,306,86,217,2006,89,86,195,183,180,86,86,306,89,28,28,0,86,4,4,4,4,4,6,2,2,2,12,12,0,2023-12-23 04:58:00,0
5567,5568,5568,5568,2021,89,332,89,214,2021,118,89,203,190,188,89,89,332,118,31,31,0,89,7,7,7,7,6,4,2,2,2,13,13,1,2023-12-23 05:00:00,0
5624,5622,5623,5623,2015,93,555,93,212,2015,343,93,218,204,199,93,93,555,343,28,28,0,93,4,4,4,4,4,10,2,2,2,14,14,0,2023-12-23 05:02:00,0
5612,5613,5613,5613,2034,89,425,89,215,2034,210,89,208,190,189,89,89,425,210,28,28,0,89,4,4,4,4,3,2,2,2,2,18,18,1,2023-12-23 05:04:00,0
5603,5623,5603,5603,2036,91,348,91,221,2036,127,91,197,194,189,91,91,348,127,31,31,5,91,7,7,7,7,7,10,2,2,2,3,3,0,2023-12-23 05:06:00,0
5590,5590,5590,5590,2027,95,317,95,210,2027,107,95,187,183,179,95,95,317,107,28,28,0,95,4,4,4,4,4,8,2,2,2,4,4,0,2023-12-23 05:08:00,0
5621,5621,5621,5621,2032,91,339,91,213,2032,126,91,206,199,195,91,91,339,126,27,27,0,91,3,3,3,3,3,8,2,2,2,7,7,0,2023-12-23 05:10:00,0
5577,5576,5576,5576,2027,90,314,90,206,2027,108,90,194,186,182,90,90,314,108,28,28,4,90,4,4,4,4,4,8,2,2,2,8,8,0,2023-12-23 05:12:00,0
5627,5627,5627,5627,2029,92,354,92,222,2029,132,92,207,196,192,92,92,354,132,31,31,0,92,7,7,7,7,7,8,2,2,2,11,11,0,2023-12-23 05:14:00,0
5635,5636,5636,5636,2040,82,351,82,217,2040,134,82,202,195,190,82,82,351,134,28,28,2,82,4,4,4,4,3,10,2,2,2,7,7,1,2023-12-23 05:16:00,0
5584,5583,5583,5583,2033,85,323,85,209,2033,114,85,194,185,183,85,85,323,114,28,28,2,85,4,4,4,4,4,4,2,2,2,9,9,0,2023-12-23 05:18:00,0
5573,5575,5574,5574,2026,95,339,95,211,2026,128,95,190,180,176,95,95,339,128,28,28,0,95,4,4,4,4,3,8,2,2,2,10,10,1,2023-12-23 05:20:00,0
5531,5530,5530,5530,1999,95,321,95,214,1999,107,95,199,186,177,95,95,321,107,31,31,2,95,7,7,7,7,7,18,2,2,2,13,13,0,2023-12-23 05:22:00,0
5575,5575,5575,5575,2030,82,335,82,211,2030,124,82,192,183,183,82,82,335,124,28,28,0,82,4,4,4,4,4,0,2,2,2,9,9,0,2023-12-23 05:24:00,0
5587,5587,5587,5587,2030,98,325,98,220,2030,105,98,196,191,190,98,98,325,105,27,27,0,98,3,3,3,3,3,2,2,2,2,5,5,0,2023-12-23 05:26:00,0
5612,5613,5613,5613,2038,96,342,96,225,2038,117,96,186,174,173,96,96,342,117,32,32,6,96,8,8,8,8,8,2,2,2,2,12,12,0,2023-12-23 05:28:00,0
5583,5581,5581,5581,2031,92,319,92,207,2031,112,92,207,199,196,92,92,319,112,27,27,0,92,3,3,3,3,3,6,2,2,2,8,8,0,2023-12-23 05:30:00,0
5649,5651,5651,5651,2039,93,342,93,212,2039,130,93,210,196,192,93,93,342,130,28,28,0,93,4,4,4,4,3,8,2,2,2,14,14,1,2023-12-23 05:32:00,0
5580,5577,5577,5577,2020,98,323,98,222,2020,101,98,194,180,179,98,98,323,101,28,28,0,98,4,4,4,4,4,2,2,2,2,14,14,0,2023-12-23 05:34:00,0
5613,5616,5616,5616,2039,91,339,91,228,2039,111,91,208,197,193,91,91,339,111,31,31,1,91,7,7,7,7,6,8,2,2,2,11,11,1,2023-12-23 05:36:00,0
5594,5594,5594,5594,2035,105,325,105,224,2035,101,105,187,182,176,105,105,325,101,28,28,0,105,4,4,4,4,4,12,2,2,2,5,5,0,2023-12-23 05:38:00,0
5641,5641,5641,5641,2028,99,335,99,212,2028,123,99,205,199,194,99,99,335,123,28,28,0,99,4,4,4,4,4,10,2,2,2,6,6,0,2023-12-23 05:40:00,0
5590,5589,5589,5589,2032,89,310,89,209,2032,101,89,199,193,192,89,89,310,101,27,27,4,89,3,3,3,3,3,2,2,2,2,6,6,0,2023-12-23 05:42:00,0
5592,5593,5593,5593,2034,93,331,93,212,2034,119,93,203,191,187,93,93,331,119,32,32,0,93,8,8,8,8,8,8,2,2,2,12,12,0,2023-12-23 05:44:00,0
5520,5520,5520,5520,2010,92,301,92,212,2010,89,92,197,190,189,92,92,301,89,26,26,0,92,3,3,3,3,3,2,2,2,2,7,7,0,2023-12-23 05:46:00,0
5607,5607,5607,5607,2028,103,338,103,214,2028,124,103,194,187,185,103,103,338,124,28,28,4,103,4,4,4,4,3,4,2,2,2,7,7,1,2023-12-23 05:48:00,0
5579,5578,5578,5578,2019,93,339,93,216,2019,123,93,200,190,185,93,93,339,123,32,32,0,93,8,8,8,8,8,10,2,2,2,10,10,0,2023-12-23 05:50:00,0
5668,5669,5669,5669,2023,98,468,98,220,2023,248,98,212,202,196,98,98,468,248,27,27,0,98,3,3,3,3,3,12,2,2,2,10,10,0,2023-12-23 05:52:00,0
5617,5615,5615,5615,2031,94,342,94,210,2031,132,94,204,195,193,94,94,342,132,28,28,2,94,4,4,4,4,3,4,2,2,2,9,9,1,2023-12-23 05:54:00,0
5586,5588,5587,5587,2031,87,325,87,209,2031,116,87,211,206,200,87,87,325,116,28,28,0,87,4,4,4,4,4,12,2,2,2,5,5,0,2023-12-23 05:56:00,0
5544,5544,5545,5545,2027,75,321,75,216,2027,105,75,193,186,182,75,75,321,105,31,31,4,75,7,7,7,7,6,8,2,2,2,7,7,1,2023-12-23 05:58:00,0
5570,5570,5570,5570,2034,97,311,97,206,2034,105,97,194,182,181,97,97,311,105,28,28,0,97,4,4,4,4,4,2,2,2,2,12,12,0,2023-12-23 06:00:00,0
5626,5625,5625,5625,2017,101,669,101,215,2017,454,101,195,181,178,101,101,669,454,28,28,0,101,4,4,4,4,4,6,2,2,2,14,14,0,2023-12-23 06:02:00,0
5564,5564,5564,5564,2023,89,311,89,220,2023,91,89,208,196,196,89,89,311,91,31,31,4,89,7,7,7,7,7,0,2,2,2,12,12,0,2023-12-23 06:04:00,0
5540,5540,5540,5540,2023,89,313,89,203,2023,110,89,192,187,182,89,89,313,110,29,29,0,89,4,4,4,4,4,10,2,2,2,5,5,0,2023-12-23 06:06:00,0
5608,5609,5609,5609,2027,94,326,94,213,2027,113,94,211,205,203,94,94,326,113,27,27,2,94,3,3,3,3,3,4,2,2,2,6,6,0,2023-12-23 06:08:00,0
5567,5567,5567,5567,2010,90,344,90,213,2010,131,90,194,186,181,90,90,344,131,27,27,0,90,4,4,4,4,3,10,2,2,2,8,8,1,2023-12-23 06:10:00,0
5603,5601,5601,5601,2028,94,330,94,220,2028,110,94,193,185,183,94,94,330,110,32,32,0,94,8,8,8,8,8,4,2,2,2,8,8,0,2023-12-23 06:12:00,0
5567,5567,5567,5567,2022,95,323,95,215,2022,108,95,207,197,195,95,95,323,108,27,27,4,95,3,3,3,3,3,4,2,2,2,10,10,0,2023-12-23 06:14:00,0
5594,5595,5595,5595,2017,94,339,94,204,2017,135,94,212,205,201,94,94,339,135,28,28,0,94,4,4,4,4,4,8,2,2,2,7,7,0,2023-12-23 06:16:00,0
5587,5588,5588,5588,2027,90,318,90,215,2027,103,90,198,185,185,90,90,318,103,28,28,0,90,4,4,4,4,4,0,2,2,2,13,13,0,2023-12-23 06:18:00,0
5550,5549,5549,5549,2025,94,311,94,204,2025,107,94,203,194,193,94,94,311,107,31,31,0,94,7,7,7,7,6,2,2,2,2,9,9,1,2023-12-23 06:20:00,0
5567,5566,5566,5566,2017,94,416,94,204,2017,212,94,198,183,182,94,94,416,212,28,28,0,94,4,4,4,4,4,2,2,2,2,15,15,0,2023-12-23 06:22:00,0
5622,5623,5623,5623,2023,86,353,86,228,2023,125,86,208,197,195,86,86,353,125,28,28,3,86,4,4,4,4,3,4,2,2,2,11,11,1,2023-12-23 06:24:00,0
5586,5587,5587,5587,2028,95,317,95,212,2028,105,95,198,192,187,95,95,317,105,31,31,0,95,7,7,7,7,7,10,2,2,2,6,6,0,2023-12-23 06:26:00,0
5600,5600,5600,5600,2021,95,446,95,224,2021,222,95,197,189,188,95,95,446,222,28,28,0,95,4,4,4,4,4,2,2,2,2,8,8,0,2023-12-23 06:28:00,0
5577,5575,5575,5575,2031,90,323,90,206,2031,117,90,202,197,196,90,90,323,117,27,27,4,90,3,3,3,3,3,2,2,2,2,5,5,0,2023-12-23 06:30:00,0
5575,5577,5577,5577,2019,102,325,102,214,2019,111,102,207,200,195,102,102,325,111,28,28,0,102,4,4,4,4,4,10,2,2,2,7,7,0,2023-12-23 06:32:00,0
5546,5545,5545,5545,2005,86,353,86,226,2005,127,86,202,193,190,86,86,353,127,31,31,4,86,7,7,7,7,7,6,2,2,2,9,9,0,2023-12-23 06:34:00,0
5594,5613,5594,5594,2032,83,322,83,216,2032,106,83,210,203,200,83,83,322,106,28,28,0,83,4,4,4,4,3,6,2,2,2,7,7,1,2023-12-23 06:36:00,0
5591,5592,5592,5592,2028,90,330,90,218,2028,112,90,196,186,185,90,90,330,112,28,28,0,90,4,4,4,4,4,2,2,2,2,10,10,0,2023-12-23 06:38:00,0
5566,5566,5566,5566,2027,89,320,89,222,2027,98,89,196,188,185,89,89,320,98,28,28,2,89,4,4,4,4,3,6,2,2,2,8,8,1,2023-12-23 06:40:00,0
5592,5591,5591,5591,2018,94,337,94,215,2018,122,94,196,187,185,94,94,337,122,31,31,0,94,7,7,7,7,7,4,2,2,2,9,9,0,2023-12-23 06:42:00,0
5579,5578,5578,5578,2020,93,336,93,213,2020,123,93,210,196,194,93,93,336,123,28,28,1,93,4,4,4,4,4,4,2,2,2,14,14,0,2023-12-23 06:44:00,0
5556,5557,5557,5557,2017,92,324,92,202,2017,122,92,196,189,186,92,92,324,122,27,27,1,92,3,3,3,3,3,6,2,2,2,7,7,0,2023-12-23 06:46:00,0
5565,5565,5565,5565,2031,85,323,85,220,2031,103,85,194,181,179,85,85,323,103,32,32,0,85,8,8,8,8,8,4,2,2,2,13,13,0,2023-12-23 06:48:00,0
5568,5568,5568,5568,2033,92,361,92,210,2033,151,92,195,189,187,92,92,361,100,28,28,4,92,4,4,3,3,3,4,2,2,2,6,6,0,2023-12-23 06:50:00,52
5576,5577,5577,5577,2022,98,429,98,211,2022,218,98,188,180,178,98,98,429,218,28,28,0,98,4,4,4,4,4,4,2,2,2,8,8,0,2023-12-23 06:52:00,0
5620,5620,5620,5620,2030,104,339,104,207,2030,132,104,199,190,185,104,104,339,132,28,28,0,104,4,4,4,4,4,10,2,2,2,9,9,0,2023-12-23 06:54:00,0
5566,5565,5565,5565,2025,85,315,85,227,2025,88,85,198,187,186,85,85,315,88,31,31,4,85,7,7,7,7,7,2,2,2,2,11,11,0,2023-12-23 06:56:00,0
5566,5567,5567,5567,2023,95,316,95,214,2023,102,95,198,192,190,95,95,316,102,28,28,0,95,4,4,4,4,4,4,2,2,2,6,6,0,2023-12-23 06:58:00,0
5558,5557,5557,5557,2026,89,315,89,204,2026,111,89,191,185,184,89,89,315,111,28,28,4,89,4,4,4,4,3,2,2,2,2,6,6,1,2023-12-23 07:00:00,0
5583,5584,5584,5584,2011,84,469,84,222,2011,247,84,208,198,193,84,84,469,247,27,27,0,84,3,3,3,3,3,10,2,2,2,10,10,0,2023-12-23 07:02:00,0
5585,5585,5585,5585,2031,97,416,97,217,2031,199,97,200,190,186,97,97,416,199,31,31,0,97,7,7,7,7,7,8,2,2,2,10,10,0,2023-12-23 07:04:00,0
5593,5592,5592,5592,2026,96,340,96,207,2026,133,96,191,184,184,96,96,340,133,28,28,0,96,4,4,4,4,3,0,2,2,2,7,7,1,2023-12-23 07:06:00,0
5556,5557,5557,5557,2016,95,430,95,204,2016,226,95,184,176,175,95,95,430,226,28,28,0,95,4,4,4,4,4,2,2,2,2,8,8,0,2023-12-23 07:08:00,0
5568,5568,5568,5568,2021,96,309,96,218,2021,91,96,201,193,190,96,96,309,91,31,31,1,96,7,7,7,7,7,6,2,2,2,8,8,0,2023-12-23 07:10:00,0
5565,5565,5565,5565,2026,98,336,98,214,2026,122,98,186,181,180,98,98,336,122,28,28,0,98,4,4,4,4,4,2,2,2,2,5,5,0,2023-12-23 07:12:00,0
5559,5559,5559,5559,2022,88,328,88,211,2022,117,88,193,188,184,88,88,328,117,28,28,0,88,4,4,4,4,4,8,2,2,2,5,5,0,2023-12-23 07:14:00,0
5582,5582,5582,5582,2024,84,328,84,208,2024,120,84,198,188,188,84,84,328,120,28,28,4,84,4,4,4,4,3,0,2,2,2,10,10,1,2023-12-23 07:16:00,0
5600,5598,5598,5598,2026,98,349,98,221,2026,128,98,199,184,181,98,98,349,128,31,31,0,98,7,7,7,7,7,6,2,2,2,15,15,0,2023-12-23 07:18:00,0
5589,5591,5591,5591,2020,89,336,89,212,2020,124,89,208,200,198,89,89,336,124,27,27,1,89,3,3,3,3,3,4,2,2,2,8,8,0,2023-12-23 07:20:00,0
5559,5558,5558,5558,2027,82,342,82,215,2027,127,82,190,187,184,82,82,342,127,28,28,1,82,4,4,4,4,3,6,2,2,2,3,3,1,2023-12-23 07:22:00,0
5564,5564,5564,5564,2006,95,335,95,231,2006,104,95,197,187,182,95,95,335,104,32,32,0,95,8,8,8,8,8,10,2,2,2,10,10,0,2023-12-23 07:24:00,0
5591,5593,5592,5592,2021,91,349,91,214,2021,135,91,204,193,191,91,91,349,135,27,27,0,91,3,3,3,3,3,4,2,2,2,11,11,0,2023-12-23 07:26:00,0
5597,5597,5597,5597,2032,92,325,92,224,2032,101,92,192,185,184,92,92,325,101,28,28,0,92,4,4,4,4,4,2,2,2,2,7,7,0,2023-12-23 07:28:00,0
5566,5567,5566,5566,2025,95,304,95,208,2025,96,95,198,191,189,95,95,304,96,28,28,1,95,4,4,4,4,4,4,2,2,2,7,7,0,2023-12-23 07:30:00,0
5600,5599,5599,5599,2011,91,346,91,219,2011,127,91,201,193,190,91,91,346,127,31,31,4,91,7,7,7,7,6,6,2,2,2,8,8,1,2023-12-23 07:32:00,0
5594,5595,5595,5595,2023,94,344,94,226,2023,118,94,202,191,187,94,94,344,118,28,28,0,94,4,4,4,4,4,8,2,2,2,11,11,0,2023-12-23 07:34:00,0
5580,5578,5578,5578,2027,94,329,94,225,2027,104,94,189,181,175,94,94,329,104,28,28,4,94,4,4,4,4,3,12,2,2,2,8,8,1,2023-12-23 07:36:00,0
5582,5584,5584,5584,2023,96,416,96,204,2023,212,96,196,181,179,96,96,416,212,27,27,0,96,3,3,3,3,3,4,2,2,2,15,15,0,2023-12-23 07:38:00,0
5571,5571,5571,5571,2018,88,339,88,218,2018,121,88,203,195,193,88,88,339,121,32,32,0,88,8,8,8,8,8,4,2,2,2,8,8,0,2023-12-23 07:40:00,0
5563,5563,5563,5563,2006,93,355,93,216,2006,139,93,199,189,185,93,93,355,139,27,27,4,93,3,3,3,3,3,8,2,2,2,10,10,0,2023-12-23 07:42:00,0
5597,5597,5597,5597,2024,94,325,94,210,2024,115,94,201,192,191,94,94,325,115,28,28,0,94,4,4,4,4,4,2,2,2,2,9,9,0,2023-12-23 07:44:00,0
5482,5519,5481,5481,2008,89,311,89,203,2008,108,89,198,192,187,89,89,311,108,31,31,4,89,7,7,7,7,7,10,2,2,2,6,6,0,2023-12-23 07:46:00,0
5565,5565,5565,5565,2015,97,320,97,206,2015,114,97,193,183,180,97,97,320,114,28,28,0,97,4,4,4,4,3,6,2,2,2,10,10,1,2023-12-23 07:48:00,0
5581,5577,5577,5577,2033,101,317,101,225,2033,92,101,184,177,174,101,101,317,92,28,28,0,101,4,4,4,4,4,6,2,2,2,7,7,0,2023-12-23 07:50:00,0
5596,5601,5601,5601,2027,90,331,90,208,2027,123,90,210,199,196,90,90,331,123,28,28,2,90,4,4,4,4,4,6,2,2,2,11,11,0,2023-12-23 07:52:00,0
5579,5578,5578,5578,2022,84,353,84,228,2022,125,84,199,192,186,84,84,353,125,31,31,0,84,7,7,7,7,7,12,2,2,2,7,7,0,2023-12-23 07:54:00,0
5614,5615,5615,5615,2029,93,355,93,215,2029,140,93,194,185,183,93,93,355,140,28,28,3,93,4,4,4,4,4,4,2,2,2,9,9,0,2023-12-23 07:56:00,0
5621,5640,5620,5620,2033,91,456,91,210,2033,246,91,207,201,198,91,91,456,246,28,28,1,91,4,4,4,4,4,6,2,2,2,6,6,0,2023-12-23 07:58:00,0
5562,5582,5563,5563,2021,84,328,84,215,2021,113,84,208,193,190,84,84,328,113,28,28,0,84,4,4,4,4,3,6,2,2,2,15,15,1,2023-12-23 08:00:00,0
5550,5550,5550,5550,2002,93,530,93,216,2002,314,93,218,202,200,93,93,530,314,31,31,4,93,7,7,7,7,7,4,2,2,2,16,16,0,2023-12-23 08:02:00,0
5579,5579,5579,5579,2024,90,334,90,207,2024,127,90,194,188,186,90,90,334,127,27,27,0,90,3,3,3,3,3,4,2,2,2,6,6,0,2023-12-23 08:04:00,0
5614,5614,5614,5614,2031,87,337,87,217,2031,120,87,197,185,182,87,87,337,120,28,28,0,87,4,4,4,4,3,6,2,2,2,12,12,1,2023-12-23 08:06:00,0
5607,5607,5607,5607,2025,97,336,97,224,2025,112,97,203,191,189,97,97,336,112,32,32,2,97,8,8,8,8,8,4,2,2,2,12,12,0,2023-12-23 08:08:00,0
5546,5546,5546,5546,2016,94,321,94,209,2016,112,94,197,183,179,94,94,321,112,27,27,0,94,3,3,3,3,3,8,2,2,2,14,14,0,2023-12-23 08:10:00,0
5595,5595,5595,5595,2025,84,345,84,219,2025,126,84,210,197,189,84,84,345,126,28,28,0,84,4,4,4,4,4,16,2,2,2,13,13,0,2023-12-23 08:12:00,0
5590,5590,5590,5590,2035,91,322,91,208,2035,114,91,192,188,188,91,91,322,114,28,28,0,91,4,4,4,4,4,0,2,2,2,4,4,0,2023-12-23 08:14:00,0
5563,5563,5563,5563,2035,92,312,92,217,2035,95,92,193,1